))%^^^%)))))))%^^((^%)-----++-+-)))))))))))--+--+++--)%%))))))rr
)%^^^^^%))))-)%^^(^^%)-+++++-+--)))))))---)--------+-)%%))))))rr
)%^^^^^%)---)%^^^((^%)-++++----))))))))-+-)--$%%%-----%^%)))))rr
%^^^^^^^%-+--%%^^^^^%)-+++++--)))))))))---)---%^^%-++-%^^%))))rr
^^^^^^^%%-++-))%%%%%))--+-+-+-))---))))))))----%%--++--%%%)$%%rr
^^^^^^%)---+--)------))--+++-----+----)))))$---))-----))))))%^rr
^^^^^%))-----))-++--))))-+++--++++-++---))%^%))))))%%))))))))%rr
^^^^^%)))))))))-----------+-+++++++++-+-))%^^%))))%^^%))))))))rr
^^^^^^%)))))))))))))-++----++++++++++---)%^^^%))))%^^^%)))))))rr
%^^^^^^%))))))))))))--+-))-++++++++-++-))%^^^%)))))%^^^%%%))))rr
)%^^^^^%)))))))))))-----))-----++------))%^^^%))))))%^^^^^%%))rr
%^^^^^^^%)))))))))))-)))))))))-+--)))))))%^^^%)))))))%^^^^^^%%rr
^^^^^^^^^%))))))))))))))))))))---))))))))%^^^^%)))))))%%%%^^^^rr
^^^^^^^^^^%)))))))))))))))))))))))))))))))%^^^^%))))))))))%^^^rr
^^^^^^^^^^^%%)))))%%)))))))))))))))))))))))%%^^^%)))))))))%^^^rr
^^^^^^^^^^^^^%)))%^%)))))))))))))))))))))))))%%%%)))))))))%^^^rr
^^^^^^^^^^^^^^%)%^%%)))))))))))))))))))))))))))))))))))))%^^^^rr
^^^^^^^^^^%%%^^%^%)))))))))))))))))$))))))))))))))))))))%^^^^^rr
^^^^^^^^^%)))%^^%))))))))))))))))%%^%))))))))))))))-)))%^^^^^^rr
^^^^^^^^^%))))%%)))))))))))))))))%^^^%))))%%))))))--)-%^^^^^^^rr
^^^^^^^^^%)))))))))))))))))))))))%^^^^%))%^^%))))))))-%^^^^^^^rr
^^^^^^^^^%))))))))))))))))))))))))%^^^^%%^^^^%))))))))%^^^^^^^rr
^^^^^^^^^^%)))))))))%%%%%%%)))))))%^^^^^^^^^^^%%))))))%^^^^^^^rr
^^^^^^^^%%%))))))))%^^%%%^^%))-)))%^^^^%%%%%%%%%)))))))%^^^^^^rr
^^^^^%%%))%%))))))%^^%)))%^^%))---%^^^%----)))))))))))))%%%%%^rr
^^^^%)))))%^%)))))%^%))-))%^%))-+-%^^%--++-)))))))))))))-----%rr
^^^^%)))))%^%)))))%^%)-)))%^%)----%^^%--+--)))))))))))))-++--)rr
^^^^%)))))%^^%))))%^%))))-%^%))--%^R^%)-+-))))))))))))))---+-)rr
^^^^%))))$^^R%)))%^^^%-))%^^^%)))%^R^^%---))))))))))))))))---)rr
%%%%))))))%^RR%%%^^^^^%)%^^^^^%%%^^R^^^%))))))))))))))))))))))rr
))))))))))%^^RR^^^^^^^^%^^^^^^^^^^^^^^^^%)))))%%%%%%%%%%%%%%%)rr
)))))))))))%^^^^^^^^^^^^^^^^^^^^^^^^^^^^^%)))%^^^^^^^^^^^^^^^%rr
))))))))))))%%%%%%^^^^^^^^^^^^^^^((^^^^^^%)))%^^^^^^%%%%%%^^^^rr
))))))))))))))))))%^^^^^%%%%%^^^^^((^^^^^%)))%^^^^^%))))))%%%^rr
))))))))))))))))))%^^^^%)))))%^^^^^^^^^^^%)))%^^^^%--))))))))%rr
))))))))))))))))))%^^^^%))))))%^^^^^^^^^^%))))%^^%----))))))))rr
))))))))))))-)----%^^^^^%)))))%^^^^^^^^^%-)-))-%%--++--)))))))rr
))))))))))))))-++-%^^^^^^%%))%^^^^^^^^^^%)-))))---+-++-)))))))rr
))%%)))))))))--+--)%^^^^^^^%%^^^^^^^^^^^%)-))))--++++--)))))))rr
)%^^%%)))))$)-++---%^^^^^^^^^^^^^^^^^^%%)))))))----+-+--))))))rr
%^^^^^%))%%^%---+---%^^^^^^^^^^^^^^^%%))))))))))))---+-)))))))rr
^^%%^^^%%^^^%-)-----%^^^^^%%%%%^^^^%)))---))))))))))---)))))))rr
%%))%^^^rRR^^%))))---%^^^%)))))%^^^%)))-+--)))))))))))))))))))rr
)))))%^RrrrR^%))))))))%%%)))))))%^^%)-)-++--))))))))))))))))))rr
)))))%^RrRRR^^%%)))))))))))))))%^^^^%)--+-+-))))))))))))))))))rr
))))))%^^^^^^^^^%%))))))))))))%^^^^^^%---+--))))))))))))))))))rr
))))))%^^^^^^^^^^%))))))))))%%^^^^^^^^%%-++--)))))))))))))))))rr
))))))%^^%%%%^^^^%)))))))))%^^^^^^^^^^%%---+-))$)))))))-)-))))rr
)))))))%%))))%%^%%)))))))))%%^^^^^^^^%))-)---)))))))))))))))))rr
)))))))))))))))$)))))))))))))%^^^^^^%---))))))))))))))))))))))rr
)))))))--)))))))))))))))-)))))%^^^^%--+-))))))))))))))))))))))rr
)))))))-))))))))))))))---)))))%^^^^^%-+-))))))))))))))))))))))rr
))))))))-)))))))))))))-+--))))%^^^^^%---))))))))))))))%%))))))rr
))))%%%%%%%)))))))))))--+-))))%^^^^^%)))))))))))----)%^^%)))))rr
))))%^^^^^^%))))))))))-+-----)%^^^^^%))-)))))%%%%-+--%^^%)))))rr
))))%^^RR^^^%)))))))))----+---%^^^^^%)))-))))%^^%-++-)%^%))---rr
---))%^^^^^^^%)))))))))))--++-%^^^^^%)-))))))%^^%--+-)%%%))-+-rr
+++))%^^^^^^^^%%))))))%%)-+---)%%^^^%-))))))%^^^%---)))))))-++rr
+++)))%^^%%%%^^^%%%%%%^^%---)))))%^^%)))-))%^^^^^%%-)))))---++rr
-+-))))%%))))%%^^^^^^^^%%)))))))--%%-)))---%%%%%%%%%)))))-++++rr
+--))-----)))))%%%%%%%%)))))))))-----))--+---))))))))))))-++++rr
--)))-+-+-))))))))))))))))))))))------)-++++-))))))))))))-+++-rr
rrrrrrrrrrrrrrrrrrrrrrrrrrrrrrrrrrrrrrrrrrrrrrrrrrrrrrrrrrrrrrrr
rrrrrrrrrrrrrrrrrrrrrrrrrrrrrrrrrrrrrrrrrrrrrrrrrrrrrrrrrrrrrrrr
