)%(%)))))))))))))))))))))))))))%%))))))))))))))))))))))---((%)rr
%%%)))))))))))%%)))))))))))))))))))))))))))))))))))))))-+--%(%rr
$))))))))))%%%^^%)))))))))))))))))))))))))))))))))))))--+--%(^rr
))))))))))%^^^^^%)))))))))))))))))))))))))))))))))))))-+----%%rr
))))))))))%^^((^%)))))))))))))))))))----)))))))())))))---)))))rr
)))))))))))%^^^^^%)))))))-)))))))))--++--)))))%(%))))))%%%))))rr
)))))))))))%^^^(^%)))))))------))))-+++---)))$^(%)))))%(^%))))rr
))))))))))))%%^^%))))))))-++-+-))))---+++-))))(^%)))))%^%---))rr
)))))))))))))-%%-))))))))-++++--))))-+-++-))))%%)))))))$--+---rr
))))))))%%%%)-----)))))))-----+-))))------))))))))))))))-+++--rr
))))))%%^^^^%-+++-%%%%(%%%%%----))))))-)))))))))))))))))--+++-rr
)))---%^^^^^%-+---%^R^^^^(^^%-----)))))))))$)))))))))))))-----rr
)))))))%%^^^%---)%^RRR^^^^^^^%--+--)))()))$%%)))))))))))))))))rr
%%)))))))%^^^%)))%^^rRR^(^^%%%-+++-)))())$)))$))))))))))))))))rr
^%))))))))%^^%)))%^^^^(^^^%)-$-+---))))%%)))))$%%%%%))))))))))rr
^%))))))))%^^%)))%%^^^^^^%))---++-)))))$)))))))%^^^%))))))))))rr
%)))))))))%^^(%))%)%^^^^%)))------))))))))))))))%%^^%)))))))))rr
)))))))))%^^^^^%%^%^^^^^%)))))-$-)))))))))))))))))%^%)))))))))rr
))))))))%^^^^^^^^^^^^^(^^%))))%^%%%)))))))))))))))%^%)))))))))rr
)))))))%^^^^^^^^^^^^^^^^^%))))%^^^^%)))))))))))))))%%)))))))))rr
))))))%^^^^^^%%%%%^^^%%%%))))))%%%%%)))))))))))))))%%)))))))))rr
))))))%^^^^^%)))))%^%)))))))))))))))))))))))))))))))%%))))))))rr
)))))%^^^^^^%)))))%^%))))))%%))))))))))))))))))))))))%%%%)))))rr
%))%%^^^^^^^%)))))%^%)))))$^%)))))))))))))))))))))))))%%))))))rr
^%%^^^^^^^^^%))))))%%))))))$))))))))))))))))))))))))))))))))))rr
^^^^^^^^^^^%))))))))))))))))))))))))))))))))))))))))))))))))))rr
^^^^^^^^^^^%))))))))))))))))))))))))))))))))))))))))))))))))))rr
%%^^^%%%%%%)))))))))))))))))))))))))))))))))))))))))))))))))))rr
))%%%)))))))))))----))))))))))))))))))))))))))))))))))))))))))rr
)))))))))))%%%))-+--))))))))))))))))))))))))))))))))))))))))))rr
)))))))))))%^^%%--+-))))))))%%)))----))))))))))))))))))%%)))))rr
)))))))))))%^^^%)-+--)))))%%^^%%%-++--)$)))))))))))))))$))))))rr
)))))))))))%^^^%----)))))%^^^^^^%-+-+-)))))))))))))))))-)---))rr
)))))))))))%^^^^%-+--)))%^^^^^^^%-++--))))))))))))))))----+-))rr
)))))))))))%^^^^%---)))%^^^^^^^^%-++-)))))))))))))))))-++++-))rr
)))))))))))%^^^^^%%%%%%^^^^^^^^^%----))))))$))))))))))------))rr
)))))))))))%^^^^^^^^^%%%%%%%%^^^%)))))))))%%))))))))))))))))))rr
))))))))))))%^^^^^^^%))))))))%%%)))))))))%%)))))))))))))))))))rr
)))))))))))))%^^^^^^%))))))))---)))))))%%%)))))))))))))%%)))))rr
))))))))))))))%^^^^^^%))))))--+-)))))))%%)))))))))))))%^^%))))rr
))))))))))))))%^^^^^^%))))))))))))))))))))))))))))))))%^^^%%))rr
%)))))))))))))%^^^^^^^%%)))--+--)))))))))))))))))))))))%^^^^%%rr
))))))))))))))%^^^%%%^^^%))+-++--))))))))))))---)))))))%^^^^^^rr
))))))))))))))%^^%)))%^^%))++++-)))))))))))))-+-))))))))%^^^^^rr
))))))))))))))%^%))))%^^%))--+--)))))))))))))---))))))))%%%%%^rr
))))))))))))))%^%)))))%^%))----))))))))))))))-+-)))))))))))))%rr
)))))))))%%%%%^^%)))))%^%))))))))))))))))))))---))))))))))))))rr
))%%%%%%%^^^^^^%))))))%^%)))))))--))))))))))))))))))))))))))))rr
)%^^^^^^^^^^^^^%)))))))%%)))))))))))))))))))))))))))))))))))))rr
)%^^^^^^^^^^^^^%)))))))%%)))))))))))))))))))))))))))))%%%%))))rr
)%^^^^^^^^^R^^^%)))))))%)))))))))))))))))))$)))))))))%^^^^%)))rr
)%^^^^^^^^RR^^%))))))))%%))))))))-))))))))%^%)))))))$^^R^^^%))rr
)%^^^^^^^RrR^^%)))))))%^%))))))))))))))))%^^%))))))))%^R^^%%%%rr
))%^^^^^^^R^^%))))))))%^%))))))%%))))))))%%%%))))))))%^^^%))))rr
))%^^^^^^^^^%)))))))))%^^%))))%^^%))))))))))))))))))))%^^%))))rr
)%^^^^^^^^^^%))))))))%^^^%))))%^%)))))))))))))))))))))%^%)))))rr
)%^^^%%%%%%%%))))))))%^^^%)))))$))))))----)))))))))))))%%)))))rr
%^^^%))))))))))))))))%^R^%))))))))))))-++-))))%%))))))%(()))))rr
^^^^%))))))))))))))))%^R^%))))))))))))--+--))$^^%%%)))%((%%%%%rr
^^^^%))))))))))))))))%^^^%)))))))))))--+++-)))%^^^%%%%%%%%%%%%rr
%%%%%)))))))))))))))))%%%))))))))))))-++++-))))%%%))))))))))))rr
)))))))))))))))))))))))))))))))))))))---+--)))))))))))))))))))rr
rrrrrrrrrrrrrrrrrrrrrrrrrrrrrrrrrrrrrrrrrrrrrrrrrrrrrrrrrrrrrrrr
rrrrrrrrrrrrrrrrrrrrrrrrrrrrrrrrrrrrrrrrrrrrrrrrrrrrrrrrrrrrrrrr
