)))))))))))))))))))))))))))--++---%%^%)))))))%%%))))))%^^^%)))rr
)))))))))))))))))))-)))))))-++++--))$)))))))))))))))))%^^%))))rr
%%%)))))))%%))))))%%%%)))))---+---)))))))))))))))))))))%%)))))rr
)))))))))%^^%)))))%^^^%%)))))---))))))))))))))))))))))))))))))rr
)))))))--%%^^%)))%^R^^^^%)))))))))))))))))))))))))))))))))))))rr
)))))))----%%^%%%^^^(^^(^%)))))))))))))))))))))))))%%)))))))))rr
)))))))------%^^^^^%%^^^^%)))%(%%)))))))))))))))))%^^%))))))))rr
))))))))--+--%^^^^%))%%^^^%))%%%%))))))))))))))))%^^^%))))))))rr
)))))))))-+-))%^^%)))))%(%^%)))))))))))))))))))))%^R^%))))))))rr
))))))))----)%^^^^%%))))))%^%))))))%%%)))$))))))%^RR^%))))))))rr
))))))))))%%%^^^^^^^%))))%^^%)))))%^^^%(%%)))))%^^R^%)))))))))rr
)))))))))%^^^^^^^^^^%))))%^^^%))))%^^^(^%)))))%^^^R^%)))))))))rr
))%%)))))%^^^^RR^^^^^%)))%^R^%)))%^^^^%%))))))%^(^^^%)))))))))rr
%%^^%))))%%^^^^^^^^^^%)))(^R^%)))%%%%%))))))))%^^^R^%)))))))))rr
^^^^%))))))%^^^^^^^^^%)))%^R^%))))))))))))))))%^^^RR%)))))))))rr
%%^^%)))))))%^^^^^^^^%)))%^R^^%))))))))))))))))%^^RR%)))))----rr
))%%%)))))))%^^^RR^^^%)))%^^^^^%))))))))))))))))%^^^%)))))-++-rr
))))))))))))%^^RrrR^^%)))%%%^^^^%%))%%%%%%)))))))%^^%)))))---+rr
))))))))))))%^RrrrR^^%))))))%^^^^^%%^^(^^^%)))))))%^%))))))-+-rr
)))))))))))%^^^RRRR^^%)))))))%^^^^^^^^^^^%))))))))%^%))))))---rr
)))))))))))%^^^^^^^^^^%)))))))%^^^^^^%%%%%))))))))%^%)))))))))rr
)))))))))))%^^^^^^^^^^^%%%)))))%%%^^%)))))))))))))%(%)))))))))rr
))))))))))%^^^^^^^^^R^^^^%))))))))%^%)))))))))))))%^%)))))))))rr
))))))))))%^^^%%%^^^^^^^%)))))))))%^%)))))))))))))%%%)))))))))rr
))))))))))%^^%)))%%^^^^^%)))))))))%^^%)))))))))))$)))$))))))))rr
))))))))))%%%))))))%%%^%))))))))))%^^^%%%))))))%%%)))%%%))))))rr
))))))))))))))))))))))$)))))))))))%^^^^^^%))))%^^%)))%^^%)))))rr
)))))))))))))))))))))))))))))))))%^^^^RR^%))))%^%)))))%^%)))))rr
)))))))))))))))))))))))$))))))))%^^%^^^^%))))))$)))))))$))))))rr
))))))))))))))))))))))%^%)))))%%^^%)%^^^%)))))))))))---)))))))rr
)))))))))))%%)))))))))%^%)))))%^^%)))%^^%)))))))))))-+--))))))rr
))))))))))%^^%))))))))%^()))))%^(%))))%%))))))))))))-++-))%%%)rr
))))))))))%%^%-)))))))%^%)))))%%%)))))))))))))))))))-++--)%^%)rr
))))))))))))%%%--)))))%^%))))))))))))))))))))))))))---++--%^%)rr
))%%%)))))))-----)))))%%)))))))))))))))))))))))))))$-----)%^%)rr
)%^^^%))))))-++--)%%%(%))))))))))%%%%)))))))))))))%(%)))))%^%)rr
)%^R^%))))))-++--)%%%%%)))))))))%^^%%)))))))))))))%%%)))))%%%)rr
)%^RR^%)))))---+-)))))))))))))%%^^%)))))---)))))))))))))))))))rr
)%^^^^^%%%%%%)---))))))))))))%^^^%))))))-+-)))))))))))))))))))rr
)%^^^^^^^^^^^%)))))))))))))))%^^^%)))))--+-)))))))))))))))))))rr
))%^^^^^^^^^^^%))))))))))))))%^^%)))))))---)-)))))))))))))))))rr
))%^^^^^^^%%^^^%%)))))%%%))))%^^%)))))))))))))))))))))))))))))rr
))%^^^^^^%--%^^^^%))))%^^%%%%^^^%)))))))))))))))))))))))))))))rr
))%^^^^%%----%^^^%))))%^^^^^^^^^%)))))))))))))))))))))))))))))rr
-)%^^%%)---+-)%^%)))))%^^^^^^^^^%)))))))))))))))))))))))))))))rr
-%^%%))))----)%%%))))))%^^^^^^RR^%))))))))))))))))))))))))))))rr
-%%)))))))%%%%%---)))))%^%%^^^RR^%)))))))))))))$)))))))))))%%)rr
-)))))))))%^^^%-+----)))$))%^^^R^%)-)))))))))))%))))))))))$^^%rr
-)))))))))%%%%--++++-)))))))%^(^%)))))))))))))%%)))))))))))%%^rr
%%))))))))))))--++-+-))))))%^^(^%)----))))))))%%)))))))))))))%rr
%))))))))))))-)--+---))))))%^^^%))--+--))%%%%%^^%)))))))))))))rr
%))))))))))))))----)))))))%^%%%)))-+--%%%^^^^^^^%)))))))))))))rr
%))))))))))))))))))))))))%^%))))))----%^^^%%%^^^%)))))))))))))rr
##)))))))))))))))))))))%%^%))))))))-+-%^^%)))%^^%)))))))))))))rr
##))))))))))))))))))))%^^%)))))))))---%^%)))))%^%)))))))))))))rr
^%))))))))))))))))))))%^^%))))))))))))%^%)))))%^^%%)))))))))))rr
^%))))))))))))))))))))%^%))))---))))))%^%))))))%^^^%))))))))))rr
%))))))))))))))-))))))%^%))))-+--)))))%^%)))))%^(^^%)))))))))%rr
()))))))))))))))-)-))))$))))--+--)))))%^%)))))%^^^%%))))))((%^rr
%)))))))))))))----))))))))))-+++-)))))%%%))))))%%%))))))))%^^^rr
))))))))))))))--+---))))))))-----)))))))))))))))))))))))))%%%%rr
))))))))))))))))))))))))))))))))))))))))))))))))))))))))))))))rr
rrrrrrrrrrrrrrrrrrrrrrrrrrrrrrrrrrrrrrrrrrrrrrrrrrrrrrrrrrrrrrrr
rrrrrrrrrrrrrrrrrrrrrrrrrrrrrrrrrrrrrrrrrrrrrrrrrrrrrrrrrrrrrrrr
