)))--^^^^^^^^^)))))))))))^^^----)^^^^^))h-)----))))))))))))))))
)))---)^^^^^^^^)))))))))))^^----))^^^^)))))-----)))))))))))))))
)))---))))))^^^^^^^^^)))))))----)))))))))))---)))))^)))))))))))
))-----))))))^^^^^^^^^)))))^))))))))))))))^^--))))^^^))))))))))
)))---)^^^)))^^^^^^^^^))))))^^)))))))--)))^^^)))))^^^^^))))))))
)))--^^^^^)))^^^^^^^^^^^^)))^^^^^^))))---^^^^)))))^^^^^^^))))))
^))-^^^^^^))))^^^^^^^^^^^))))^^^^^^^^----^^^^)))))^^^^^^^^)))))
^))^^^^^^^))))^^^^^^^^^^)))))^^^R^^^^^---^^^^^))))^^^^R^^))))))
))))^^^^^^)))))^^^^^^)))))))))^^^^^^^^---^^^^^))))^^^^^^^))))))
)))))^^^^^)))))))))^))))))))))))^^^^^^--)^^^^^^^^^^^^^^^^))))))
)))))^^^^))))))))))^))))))))))))))^^^^--))^^^^^^^^^^)^^^)))hh))
))))))^^^)))))))))^^))))))))))))))^^^)))))))^^^^^^)))))))))hh))
))))))^^^)))))))))^^^)))))^^)))))))^^)))))))--^^^-))))))))hhh))
))))))^^^)))))))^^^^^^^^^^^^)))))))))))))))-------)))))))))))))
))))))^^^)))))))^^)^^^^^^^^^)))h)))))))))))-------)))))))))))))
))))))^^^))))))^^^)))^^^^^^^)))hh))))))))^^^^----))))))))))))))
)))))^^^^))))))^^^))))^^^^^^)))hh)))))))^^^^^^-))))))))))))))))
^)))))^^^)))))^^^^))))))))^^)))))))))^^^^^^^^^^^)))))))))))))))
^)))))^^^^)))^^^^^))))))))^^^)))h))))^^^^^^^^^^^^^^^))))))h)))^
^)))))^^^^^)^^^^^^)))))))^^^^)))))))))^^^^^^^^^^^^^^^)))hhhh)))
))))))^^^^^^^^^^^^)))))))^^^^^))))))))^^^^^^^^^^^^^^^)))hhhh)))
))))))^^^^^^^^^^^^))))^^^^^^^^^)))))))))^)))^^^^^^^))))hhhhh)))
)---))^^^^^^^^^^^^^^^^^^^^^^^^^^)))))))))))))^^^^^)))))hhhhhh))
------^^^^^^^^^^^^^^^^^^^^^^^^^^^)))))))))))))^^^)))hhhhhhhhh))
------)^^^^^^^^^^^^^^^^R^^^^^^^^^))))))))))))))^))))hhhhhhhh)))
------))))))^^^^^^^^RRRRR^^^^^^^^))))))))))))))))))))))))hhh)))
------))))))))^^^^^RRRRRR^^^^^^^^)))))))))))))))))^^))))))hhh))
------)))))))))^^^RRRRRRR^^^^^^^^^))))))---)^^))^^^^^)))))hhh))
------hhhh)))))^^^RRRRRR^^^))^^^^^)))))-----^^^^^^^^^^^))))hh))
---))hhhh))))))^^^^RR^^^^^)))))))))))))------^^^^^^^^^^^))))h))
))))))hhh))))))^^^^^^^^^^))))))))))))))------^^^^^)))^^^^))))))
)))))))))))^^^^^^^^^^^^^^))))))))))))))------)^^^)))))^^^))))))
)))))))))^^^^^^^^^^^^^^^)))))))))))))))-----))^^^))))))^^))))))
)))))^^^^^^^^^^^^^^^^^^^^))))))^^^)))))))---))^^^))))))))))))))
)))))^^^^^^^^^^^^^)))^^^^)))))^^^^)))))))))))^^^^^^))))))))^^))
))))))^^^^^^^^^^^)))))^^^))))))^^)^^))))))))^^^^^^^^))))))^^^^^
)))))))^^^^^^^^^^)))))))))))))))))^^)))))))^^^^^^^^^^)))))^^^^^
^)))))))^^^^^^^^^)))))))))))))))))))))hh)))^^^^^^^^^^)))))))^^^
^)))h)))))^^^^^^^^^^)))))))^))))))))))hh)))^^^^^^^^^^))))))))^^
^)))))))))^^^^^^^^^^^)))))^^^)))))))))hh)))^^^^^^^^^^)))))h)))^
^))-)))))^^^^^^^^^^^^)))))^^^))))))))))h)))^^^^^^^^^^))))hhh)))
^)))---)^^^^^^^^^^^))))))))))))))))^)))h)))^^))))))))))))))))))
^)))---^^^^^^^^^^^))))))))))))))))^^)))h)))^^))))))))))))))))))
^)))-^^^^^^^^^^^^)))))))))))))))))^^^))h)))^^)))))))))))))))))^
^^)))^^^^^^^^^^^^))))))))))))))))^^^)-----)^^))))))))))))))))^^
^^)))^^^^^^^^^^^^)))))))))))))))^^^)))----)))^))))))^^^^^^)))^^
^^)))^^R^^^^^^^^^))))))))))))))^^^)))------)))^^^^^^^^^^^^^)^^^
^))))^^^^^^^^^^^^^^))))hhh)))))^^)))))-----)-))^^^^^^^^^^^^)^^^
^)))))^^^^^))))^^^)))))hhh)))^^))))))hh----h))))^^^^^^^^^)))^^^
)))))))^^))))))))))))))hh))))^^)))))hhh----hh))))^^^^^)))))))^^
))))))))))))))))))))))hhh)))))))))hhhhhh----hh))))^^)))))))))))
))))))))))))))))))))))h))))^))))))hhhhhhh---hh)))))^)))))))))))
))))))))))))))))))))))))))^^^)))))hhhhhhh---)))))))))))))))^)))
))))^^^^^^^^)))))))))))))^^^^^)))))hhhh))---)))))))))))))^^^)))
))))^^^^^^^^^))))))^^^))^^^^^^^))))hhh)))))))))^^)))))))^^^^^))
))))^^^R^^^^^^)))^^^^^^^^^^R^^^^)))hhh)))))))))^)))))))^^^^^^))
)))))^^^^^^^^^^)^^^^^^^^^^^^^^^))))))h)))))))))))))))))^^^^^)))
))))))^^^^^^^^^^^^^^^^^^^^^^^)))))))))))))))))))))))))))^^^))))
)))))))^^)))^^^^^^^))^^^^^)))))))))))))))))))))))))))))))))))))
)))))))))))))^^^^^))))))))))))hh)))))))))))))))h)))^^))))))))))
)))))))))))))))^))))))))))hhhhhh)))))))))))))))))))))))))))))))
)))))))))))))))))))))))))hhhhhhh)))))))))))))))))))))))))))))hh
)))))))))))))))))hhhhhh)hhhhhhhh)))))))h)))))))h))))))))hhhhhhh
