)----)^^^^^^^)))))^^^))))))))))-------^^))))-----)^^))))))^^^))
)----^^^^^^^^^)))^))))))))))))))-----^^^^))h----))^^)-----^^^))
))--^^^^^^^^^^^^)))))))))^^^^^)))))--^^^^^)h---)))^^)------^^))
)))^^^^^^^^^^^^^)))))))^^^^^^^^))))-)^^^^^)hhhh)))^^^------^)))
))^^^^^^^^^^^^^))))))))^^^^^^^^^)))))^^^^))hhh))))^^^)-----^)))
)))))))-----))))))))))^^^^^^^^^^))^^^^^^^^)))))))^^^^)-----^^))
)))))))-----))))))))))^^^^))))^^^^^^^^RR^^)))))))^^^^)----^^^))
)))))))----)))))))))^^^^^^----)^^^^RRRRR^^)))))))^^^^)----^^^))
))))))))))))))))))))^^^^^-----))^^^RRRRR^^^))))))))))))))^^^^))
)^^))))))))))))))))^^^^^^^----)))^^^RRRR^^^))))))))))^^^^^^))^^
^^^^^)))))))))))))^^^^R^^^--h))))^^^^RRR^^))))))))))))^^^^))))^
^^^^^^))))))hhh)))^^^^RR^^--h)))))^^^^^^^^))))))))))))^^^))))))
^^^^^^^))))hhhhh))^^^^^^^)))h)))))^^^^^^^^^)))))))))))^^^))))))
)^^^^^^^))))h---^^^^^^^^^)--))))))^^^^^^^^^^))))))))))^^^))))))
)^^^^^^^)))-----^^^^^^^^^---))))))^^^^^^^^^^^)))))))))^^^))))))
^^^^^^^^)))------)^^^^^^-----))))))^^^^^^^^^^)))))))))^^^))))))
^^^^^^^))--------)^^^^^)-----))))))^^^^^^^^^^^))))))))--)))))))
^^^^^))))----hhhh)))))))-----)hh)))^^^^^^^^^^^^))))------))^^^^
^^^^^))))-----hhh)))))))))))))hh)))^^^^^^^^^^^^^^))-------)^^^^
^^^^^))))----)hhhhhhh))))))))))h)))^^^^^^^)))^^^^)--------^^^^^
^^^^^^)))))-))hhhhhhhh------))))))^^^^^^^^)))^^^^^)-------^^^^^
^^^^^^^^^^))))hhhhhhh-------)^^^^^^^^^^^^))))^^^^^))-----))^^^^
^^^^^^^^^^)))hhhhhhhh--------^^^^^^^^^^^^))))^^^^^))))))))))^^^
^^^-^^^^^)))hhhhhhhh---------)^^^^^^^^^^^))h)^^R^^)))))))))))^^
^----)^^)))hhhhhhh-----------))^^^^^^^^^)))))^^R^^))))))))))))^
)----))))hhhhhhhhh--------)))h)))))))))))))))^^R^^)))))))))))))
))^^))))hhhh---hhh--------)-))hh)))))))))))^^^^R^^))))^^^^^^)))
)^^^^))hhhhh----hh------)))^)))hh))))-))))^^^^RR^^)))))^^^^^^))
^^^^^---hhhh----hhh-----))^^^)))))))---))^^^^^R^^^))))))^^^^^^^
^^^-----)))hh---hhh-----)^^^^^)))))----)^^^^^^^^^^)))))))))^^^^
^-------)))hhhhhhhhhh))))^^^^^^^^))--^^^^^^^^^^^^^-)))))))))^^^
)------)-))))hhhhhhhh))))^^^^^^^^^)--^^^^^^^^^^^^^)))))))))))^^
)------)-))))hhhhhh)))))))^^^^^^^^----^^^^^^^^^^^^^))))))))))))
)---hhh)))))))hhhh)))))))))^^^^^^^------^^^^^^^^^^^))^)))))))))
)hhhhhh)))^^^))hh))))))))))^^^^^^^-------^^^^^^^^^^)^^^^^)))))-
)))hhhhh))^^^))))))^^))))))^^^^^^^^^-----^^^^^^^^^^)^^^^^^)))))
)))))hh)))^^^^)))))^^^)))))^^^^^^^^^-----^^^^^^^^^)))^^^^^)))))
))))))hh))))^^)))))))^^^^^)))^^^^^^^^^^^^^^^^^^^^^)))^^^^^^^)))
))^^)))h))))))))))-)--^^^)))))^^^^^^^^^^^^)))^^^^^)))^^^^^^^^))
)^^^^))hhhh)))))))----^^^))))))^^^^^^^^^^)))))^^^)))))^^^^^^^^)
)^^^^^))))))))))))-----^^))))))^^^^^^^^^^)))))^^^))))))^^^^^^^^
)^^^^^)))))))))))h-----^^))))))^^^^^^^^^^)))))^^^)))h))))))^^^^
)))))))))))))))))hh----^^^^^)))^^^)))^^^^)))))^^)))hhhh)))))))^
)))))))^^^^))))))hh---)^^^^^^^))))))))^^^)))))^^)))hhhhhh))))))
))))))^^^^^^))))))h))))^^^^^^^)))))))))^)))))^^^)))hhhhhhhhh)))
))))))^^^^^^^))))))))))^^^^^^)))))))))))))))))^^))))))))))h))))
))))))^^^^^^^^))))))))^^^^^^^)))))))))))))))))^^^))))))))))))))
))))))^^^^^^^^^))^^^)^^^^^^^^^))))^^^)))))))))^^^^^^)))))))))))
))))))^^^^^^^^^^^^^)))--^^^^^^^))^^^^)))))))))))^^^^^^)))))))--
))))))^^^^)))^^^^^----------^^^^^^^^^))))))))))))))^^^^^))))---
))^^^^^^^)))))^^^-----------)^^^^^^^^^)))))))))))))^^^^^^^^----
)^^^^^^^^)))))^^^-------)hh))^^^R^^^^^)))))))))))))^^^^^^^^^^--
)^^RR^^^)))))))^--------hh))))^^^^^^^^^)))))))))))^^^^^^^^^^^--
-^^^^^^^^)))))))--------h)))))^^^^))^^^^^^^)))))))^^^^^^^^^)---
-^^^^^^^^))))))))))h---h)))^^))))))))^^^^^^^^))))))^^^^^^^))---
-^^^^^^^^^))))))))))---h))^^^^^)))))))^^^^^^^^^)))))^^^^^)))-))
-^^^^^^^^^^^)))))))))hh))^^^^^^)))))))^^^^^^^^^^^^^)))^^)))))))
^^---^^^^^^^^^^^))))))h))^^^^^^)))))^)^^^^^^^^^^^^^^)))))))))))
))----^^^^^^^^^^^^^^))))))^^^^^))^^^^^^^^^^^^^^^^^^^^))))))^^))
))-----^^^^^^^^^^^^^))))))^^^^)))^^^^^^^^^)))^^^^^^^^--))))^^^^
)h------)))))))))))))))))))^^))))^^^^^^))))))))^^^)----))))))))
hh-----))))))))))))))))))))))))))))))))))))))))))))---)))))))))
hhhhhhh))))))))))))))))h)))))))))))))))))hhhhh)))))---)h)))))))
