-)----%^%))))))))))))))))))))%^^(^%)))))))))))))%^(((%))))))))rr
)-----%^%)))))))-------)))))))%((()))))))))))))))%%%(^%)))))))rr
))(-%%^^^%%)))))-+----)))))))))%%%)))))))))))))))))))%%%))))))rr
)%(%^^^^^^^%))))---%%-))))))))))))))))))))))))))))))))))))))))rr
%(^%%^^^^^(^%)))))%^%)))))))))))))))))))))))))))))))))))))))))rr
^^%))%^(((%%%%)))%%%%%))))))))))))))))))))))))))))))))))))))))rr
^%))))%^(()))%%%%%))))))))))))))))))))))))))))))))))))))))))))rr
%-)))))%%)))))%^^%))))))))))))))))))))))))$%))))))))))))))))))rr
--))))))))))))%^%))))))))))%%%))))))))))))))))))))))))))))))))rr
--))))))))))))%^%)))))))))%^^^(%%)))---)))))))))))))))))))))))rr
+-))))))))))))%^%)))))))))%(^^^^^%)--+---)))))))))))))))))))))rr
--))))))))))))%^%))))))))%^^^^^^^%)-+--+--))))))))))))))))-)))rr
))))))))))---)%^%)))))))%^^^^^^^%)--------))))))))))))))))--))rr
)))))))))--+-)%^%)))))))%^^^^^^^%)-+--%%--))))))))))))))------rr
))))))))--++--%^%))))))%^(^^^^^^%)---$^^%%)))))))))))))--+--)-rr
))))))))-++++-)$)))))))%^^^^^^^^%)))))%^()))))))))))))))---%%)rr
--))))))------)))))))))%%^%%%%%%))))))%%%)))))))))))))))-+-%%-rr
)---))))))-++---)))))))))$))))))))))))))))))))))))))))))------rr
--+-))))))-+++-))))))))))---)))))))))))))))))))))))))))))-+-+-rr
-++--)))))-----))%%%%))))-+---)))))))))))))))))))))))))))---+-rr
--++-))))))--%%%%^^^^%%)---++-)))))))))))))))))))))))))))))-+-rr
)--+-))))))))%^^^^%%%^^%%-----)))))))%%%))))))))))))))))--)---rr
)-++-))))))))%^^^%)))%^^^%-+-))))))))%^^%)))))))))))))))+-----rr
-----)))))))))%^%)))))%^^%---)))))))))%^%)))))))))))))))-++-+-rr
+-++-)))))))))%%%--)--%%%%)))))))))))))%%)))))))))))))))--++--rr
++++--)))))))-----))---))))))))))))))))))))))))))))))))))-+++-rr
++-++-)))))))--++----+---))))))))))))))))---)))))))))))))-----rr
-+----)))))))-+++--+++++-))))))))))$)))))-+----))))))))))-))))rr
---))))))))))------+++++--))))))))%^%))))----+-)))))))))))))))rr
))))))))))))))))))----++-))%%)))%%%%%%)))-++---)-)))))))))))))rr
)))))))))))))))%%%%%%--+-)%^^%%%^%)))%%%%--+-))-))))))))))))))rr
)))))))))))))))%^^^^^%---%^^^^^^^%))))%^%)---)))-)))))))))))))rr
))))))))))))))))%%^^^%))-%%^^^^^%)))))%%))))))))-)))))))---)))rr
))))))))--))))))))%%%))----%%%%%)))))))$))))))-----)))))-+--))rr
)))))))-----))))))))))--++---))))))))))))))))--++--%%)-----)))rr
))))))--+-+-)))))))))))-++-+-)))))))))%%))))--+++-%^%)-+---)-)rr
))-----+++--)))))))))))-++---))))))))%^^%)))-+++--%^%)-+++-)))rr
)))-+-+++--)))))))))))------)))%%%%%%^^^^%))-----%^^%)-----)))rr
)))--+----))))))))))))))--%%%%%^^^^^^^^^^^%%%%--%^^%)))))-))))rr
))))--+-))))))))))))))---%^^^^^^^^^^^^^^^^^^^%--%%%%))))))))))rr
-))))---))))))))-))))--+-%^^^^^%%%^^^%%%%%^^%%))))))))))))))))rr
)))))))))))))))))))%%-++-%%^%%%---%%%)))))%%))))))))---)))))))rr
))))))))))))))))))%^%--+---$----+--)))))))))))))))---+--)))---rr
))))))))))-$)))))%^^^%---+----+----)))))))))))))---++++-)---+-rr
))))))))-%%%%-)))%^R^^%)--------)-))))))))))))))-++-----))-++-rr
))))))))%%---$))%^^^^^^%%%%-))))))%%)-----))))))----$--)------rr
)))%%%%%^%---)$%^^%%^^^^^^%))))))%^%)-+++-)))))))-%%^%%%%--)))rr
)%%^^^^^%---)))%^%--%^^^^^^%)%%%%^^^%--++-)))))))%^^^^^^%--)))rr
%^^^^^^%)-)-))-%%----%^^^^^^%^^^^^^^^%----)%%%)%%^^^^^^^%---))rr
^RRR^^%)))))))----++-%^^^^^^^^^^^^^^^^%--%%^^^%^^^%%%^^^%---))rr
^RrR^%))))))))--+-++-%^^^^^^^^^^^^^^^^^%%^^^^^^^^%)))%^^^%%%%%rr
^RRR^%)))))))))-+----%^^^^^^^^^^^^^^^^^^^^%%^^^^%))))%^^^^^^^^rr
^^^^^^%))%%%)))---))))%^^^^%%^^^^^^^^^^^^%))%^^^%))))%^^^^^^^^rr
^^^^^^^%%^^%))))))))$)%^^%%))%%%^^^^^^^^%))))%^^^%))%^^^^^^^%^rr
^^%%^^^^^^^^%)))))%%^%^^%)))))))%^^^^^^%)))))%^^^^%%^^^RR^%%)%rr
%%))%^^RR^^^%)))))%^^^^^%)))))))%^^^^^^%))))))%^^^^^^^^R^%)))%rr
)))))%^^^^^%)))))$^^^^^^%)))))))%^^^^^%))))))))%%%^^^^^^^%)---rr
))))))%%%%%)))))))%^^^^^^%%))))%^^^^^^%)))))))))))%^((^(())-++rr
))))---)))))))))))-%%^^^^^^%%%%^^^^^^%))))))))))))%^((%()----+rr
)))-++--))))))))-----%^^^^^%%%%%%^^^^%)))))))))))))%%%)--+++-+rr
)))--++--)))))))-+----%%%%%))))))%%%%))))))))))))))-)))--+++++rr
)))--++-))))))))-+++--))))))))))))))))))))))))))))))))))-+-+--rr
rrrrrrrrrrrrrrrrrrrrrrrrrrrrrrrrrrrrrrrrrrrrrrrrrrrrrrrrrrrrrrrr
rrrrrrrrrrrrrrrrrrrrrrrrrrrrrrrrrrrrrrrrrrrrrrrrrrrrrrrrrrrrrrrr
