)$)))))))))))))))%(^(^(%))))))%^(^(^^%)))))))%(^^^(RrR((^^^^%)rr
%%)))))))))))))))%(%(^^%)))))))%^^^^(%))))))%^^^^^RRRrR^^^(^^%rr
^())))))))))))))$%)))%%%)))))))%^^^(%)))))))(^^^^^^^(RR^^^^^^^rr
%)))))))))))))))))))))))))))))))%^^%%)))))))%^^^^^^^^^^^^^^^^^rr
%)))))))))))))))))))))))))))))))%^%)))())))))%%%^^^^^^^^^^%%%^rr
%)))))))))))))))))))))))))))))$%^%))))))))))))))%^^^^^^^^%)))%rr
%))))))))))))))))))))))))))))))%%))))))))))%%))))%^^^^^^%)))))rr
%))))))))))))))))))))))))))))))%%)))))))))%^%))))%^^^^^%))))))rr
%))))))))))))))))))))))))))))))%%)))))))))%^%))))%^^^^%)))))))rr
%)))))))))))))))))))))))))))))%^^%))))))))%^%)))))%%%%))))))))rr
)))))))))))))))))))))))%%%%%%%^^^%))))))))%^%)))))))))))))))))rr
)))))))))))))))-))))%%%^^^^^^^^^%%))))))))%^%)))))))))))))))))rr
)))))))))))))))-)--$^^^^^^^^^%%%))))))))))%^%)))))))))))))))))rr
))))))))))))))------%^^^^^^^%)))))))))))))%^%))))))))%%%%%))))rr
))))))))))))))-+++--%^^^(^^^%))))))))))))))$)))))))))%^^%)))))rr
)))))))))))))--+++-)%^^^(^(^%)))))))))))))))))))))))))%^%)))))rr
)))))))))))))-+-++-))%^^^^%%^%))))))))))))))))))))))))%^%)))))rr
)))))))))))))------)))%%%%))%^%%%%%)))))))))))))))))))%%))))))rr
))))))))))))))%%%-)))))))))))%^^^^^%%))))))))))))))))))$))))))rr
))))))))))))))%^%))))))))))))%^^^^^^%))))))$))))))))))))))))))rr
))))))))))))))%%))))))))))))))%%%^^^%)))))%^%)))))))))))))))))rr
)))))))))))))))$)))))))))))))))))%^^%)))))%^^%))))%%))))))))))rr
))))))))))))))))))))))))))))))))))%^%)))))%^^^%))%^^%)))))))))rr
)))))))))))))%%))))))))))))))))))))$)))))%^^^^^%%^^^^%))))))))rr
)))))))))))))%^%)))))))))))))))))))))))))%^^^^^^^^^^^%))))))))rr
))))))))%%)))%^%)))))))))))))))))))))))))%^^^^^^^^^%%%))))))))rr
))))))%%^%))))%%))))))))))))))))))))))))%^^^^^^^^%%))$))))))))rr
))))))%^%)))))))))))))))))))))))))))))))%%%^%%%%%)))))))))))))rr
)))))))$)))))))))))))))))))))))))))))))))))$))))))))))))))))))rr
))))))))))))))))))))))))))))))))))))))))))))))))))))))))))))))rr
))))))))))))))))))))))))))))))))))))))))))))))))))))))))))))))rr
))))))))))))))))))))))))))))))))))))))))))))))))))))))))))))))rr
))))))))))%%%)))))%%))))))))))))))))))))))))))))))))))))))))))rr
)))))))))%^^^%%%%%^%))))))))))))))))))))))))))))))))))))))))))rr
))))))))%^^^^^^^^^^^%))))))))))))))))))))))))))))))))))))))))$rr
)))))))%^^^^^^^^^^^%))))))))))))))))))))))))))))))))))))))))))rr
))))))%^^^^^^^^^^^^%)))))))))))))))))))))))))))))%%%%)))))))))rr
))))))%^^^^^^%%%%%^%))))))))))))))))))))))))$%%%%^^^^%%%%%))))rr
))))))%^^^^^%)))))%^%))))))))))))))))))))))))%^^^^^^^^^^^%))))rr
))))))%^^^^%%)))))%^%))))))))))))))))))))))))%^^^^%%%^^^%)))))rr
))))))%^^%%)))))))%^^%))))))))))))%%%)))))))))%%%%)))%%%))))))rr
)))))))%%)))))))))%^^^%)))))))))))%^^%))))))))))))))))))))))))rr
))%%%))))))))))))%^^^^^%)))))))))%^^^^%%))))))))))))))))))))))rr
)%^^^%)))))))))))%^^R^^%)))))))))%^^^^^%))))))))))))))))))))))rr
)%^^^%)))))))))))%^RR^^%)))))))))%^^^^^%))))))))))))))))))))))rr
))%^^%)))))))))))%^RR^^%))))))))))%^^^^%)))))))$))))))))))))))rr
))%^^%)))))))))))%^^^^^^%)))))))))%^^^^^%%%%%%%^%)))))))))))))rr
))%^^%))))))))))%^^^^^^^^%%%))))))%^^%%%%^^^^^^^%)))))))))))))rr
)%^^^%))))))))))%^^^^^%%%^^^%)))))%%%))))%%%%%%%))))))))))))))rr
)%%%%%))))))))))%^%%%%)))%%%))))))))))))))))))))))))))))))))))rr
))))))))))))))))%%))))))))))))))))))))))))))))))))))))))))))))rr
))))))))))))))%%%)))))))))))))))))))))))))))))))))))))))))))))rr
)))))))))))))%^^%)))))))))))))))))))))))))))))))))))))))))))))rr
)))))))))))))%^^^%%)))))))))))))))))))))))))))))))))))))))))))rr
)))))))))))))%^^^^^%%%%%%%%%%%%%)%%%%)))))))))))))))))))))))))rr
))))))))))))))%^^^^^^^^^^^^^^^^^%^^^^%%%))))))))))))))))))))))rr
))%%))))))))))%^^^^^^^^^^^^^^^^^^^^^^^^^%)))))))))))))))))))))rr
))##)))))))))))%^^^^^^^^^^^^^^^^^^%^^^^^^%))))))))))))))))))))rr
)$##%)))))%%%)))%^^^^^^^^^^^^^^^^%)%%^^^^^%)))))))))))))))))))rr
))%%)))))$^^^%)))%^^^^^%%%%%%%%%%))))%^^^%%)))))))))))))))))))rr
))))))))))%%%))))%%%%%%)))))))))))))))%%%)))))))))))))))))))))rr
))))))))))))))))))))))))))))))))))))))))))))))))))))))))))))))rr
rrrrrrrrrrrrrrrrrrrrrrrrrrrrrrrrrrrrrrrrrrrrrrrrrrrrrrrrrrrrrrrr
rrrrrrrrrrrrrrrrrrrrrrrrrrrrrrrrrrrrrrrrrrrrrrrrrrrrrrrrrrrrrrrr
