))))))-------)))))))))))))))))---+-%^^^%)))))-+--)))))))))))))rr
)))))--++-++-)))))))))))))))))-+++-%%^^^%))))---%%%)))))))))))rr
)))))-+-++++-)))))))))))))))))------)%^^^%%%%%%%^^^%))))))))))rr
))))---++-+--))%%%%%)))))))))))))-+-)%^^^^^(^^^^^^^^%)))))))))rr
))))---+----)))%^^^^%))))))))))))---)%^^^^^^^%%%%%(^%)))))))))rr
)))))-+--)))))%^^(^^^%)))))))))))))))%^^^^^^%)))))%^%)))))))))rr
)))))-+-))))))%^^^^%%))))))))))))))%%^^^^^^^%)))))%^%)))))))))rr
)))))---))))))(^^^%))))))%%%)))))))%^^^^^^^^%)))))%^%)))))))))rr
))))))))))))))%^^^^%%%%%%^^^%))))))%^^^^^^^^%))))))%%)))))))))rr
))))))))))))))%^^^^^^^^^^(^%))))))))%^^^^^(^%)))))))))))))))))rr
)))))))))))%%%^^^^^^^^^^^^^%)))))))))%^^^^^^%)))))))))))))))))rr
)))))))))))%^^^^^^^^^^^^^^%%))))))))--%^^^^^%)))))))))))))))))rr
)))))))))))%(^^^^^^%%%%%%%)))))))))----%%%^^^%))))))))))))))))rr
))))----))))%^^^^^%))------)$%)))))--+----%^^%))))))))))))))))rr
)))--++--))))(^^^%)))-++-+-))%%%%%%%---++--%^%)))----)))-)))))rr
)))-+-++-)))))%%%))))-++++-))%^^^^^^%---++-%^^%-)-++---)-)))))rr
)))-++++-))))))))))-)--++--)))%%%%(%-------%^^^%)---++-)))))))rr
)))-++++--))))))))))))----))))))))))))))))%^^^(^%%-----)))))))rr
)))-+-+-+-))))))))))))))))))))))))))))))))%^^^^^(^%%))))))))))rr
)))---------)))))))$))))))))))))))))))))))%^^^^^^^^%))))))))))rr
)))))))))-+-))))))%%%))))))))))----))))))))%%%%%%^^^%)))))))))rr
)))))))))-+--$)))%%))))))))$))--++-))))))))))))))%^^%)))))))))rr
)))))))))-+--)%%%%))))))))%^%))--+-)))))))))))))))%^^%)))))$))rr
)))))))))--+-)^^%))))))))%^^^%)-+--))))))))))))))%^^^%)))%%^%%rr
))))))))))---)%^%))))))))%^^^^%---)))))))))))))))%(^^%---%%%%^rr
))))))))))))))%^%))))))%%^^^^^^%%))))))))))))))))%%%%--+---))%rr
))))))))))))))%^^%)))%%^^^^^^^^^%))))))))))))))))))------+-)))rr
))))-)%%%)))))%^^%)))%^^^^^%%^^^%)))))))))))$)))))--++---+-)))rr
))----%%)))))%^^^%)))%^^^^%))%%%)))))))))))$))))))-+++--------rr
)--+-----))))%^^^%))))%^^^^%)))))))))))))$))))))))))))))))))))rr
)-+-+++---)%%^^^%)))))%^^^^%))))))))%%)%%%)))))))))---$^%%-++)rr
)-+--++-+--%^^^^%))))))%^^^^%))))))%^^%^%))))))))))))))%^%-+-)rr
)-----++--$%^^^^%))))-))%%^^%)))))%^^^^%)))))))))))))))%(%-++)rr
)))))---+---%^^^%-))-----)%^^%)))%^^^%%))))))))))))))))%^%---)rr
)))))--------%^^%)----++-)%^^^%%%^^^%))))))%%%%^))))))%^%)))))rr
%%%%%%-)))-+--%%---+-----)%%%%%%%%%^%)))))%^^^^^%)))))%^%)))))rr
^^^^^^%%))-++----+--++-)))))-------%^%)))%^^^%%^))))))%%))))))rr
^^^^^^^^%)---++-++-+++-)))))-++++--%^^%%%^^^%)))))))))))))))))rr
^^^^^^^^^%%%--++-------)))))--+-+-%^^^^^^^^^%)))))))))))))))))rr
^^^^^^^^^^^^%-----%%%%)))))))-----%^^^^^^^^^%))))))%%----)))))rr
^^^^^^^^^^^^^%%)%%^^^^%%)))))-)))%^^^^^^^^^^^%))))$%^%---)))))rr
^^^^^^%%%^^^^^^%^^^^^^^^%))))))))%^^^^^^^^^^^^%%%%))%^%%-)))))rr
^^^^^%)))%^^^^^^^^%%%^^^^%))))))%^^^^^^^^^^^^^^^^%)))%^^%%%%%%rr
^^^^^%)))%^^^^^^^%---%^^^^%)))$%^^^^^^^^^^^^^^^^%)))))%^^^^^^^rr
^^^^^%)))%^^^%%%%)-+-%%%%%-))))%%^^^^^^^^^^^^^^%)))))))%^^^^^^rr
^^^^^%)))%^^%)))))----------)))))%%%%^^^^^^^^^^%))))))))%^^^^^rr
^^^^^%))))%%)))))))---+++++--))))))))%^^^^^^^^%))))))))))%^^^^rr
^^^^^%))))%%))))))))-+--++++--))))))))%^^^^^^^^%%%%%%))))%^^^^rr
^^^^%%))))))))))))))--+-------))))))))%^^^^^^^^^^^^^^%))%^^^^(rr
^^%%)))))))))))))))))--++--%%%%%))))))%^^^^^^^^^^^^%%^%%^^^^^^rr
^%))))))))))))))))))))-+--%^^^^^%))))%^^^^^^^RRR^^%))%^^^(^^^^rr
%)))))))))))))))))))-)---%^^^^^^%))))%^^^^^^^RrR^%))))%^^^^^^^rr
%))))))))))))))))))))-)-%^^^^^%%))))))%^^^^^^^R^^%)))-)%%^^^^^rr
##%)))))))))))))))))))-%^^^^^%)))))))))%^^^^^^^^%))))-)))%^^^^rr
##^%%)))))))))))))%%%%%^^^^^%)))))))))))%^^^^^^^%)))))))))%^^^rr
^^^^^%%)))))))))%%^^^^^^^^^^%))))))))))))%^^^^^^%----)))))%^^^rr
RR^^^^^%)))))))%^^^^^^^^^^^^%))))))))))))%^^^^^^%-++-)))))%^^^rr
R^%%%^^^%%))))%^^^^^^RRrRR^^%)))))))))))%^^^^^^^%-----)))%^^^^rr
^%)))%^^^^%%%%^^^^^^^RRrR^^%))))))-))))%^^^^^^^^^%--))%%%^^^^^rr
%---))%^^^^%^^^^^^^^^^^R^^%)))))))---))%%%%%%%%%%)))))%%^^^^^^rr
--+--))%%%%)%%%%%%%%%%%%%%))))))))-+-)))))))))))))))))))%%%%%%rr
-+-+-)))))))))))))))))))--))))))))---)))))))))))))))))))))))))rr
rrrrrrrrrrrrrrrrrrrrrrrrrrrrrrrrrrrrrrrrrrrrrrrrrrrrrrrrrrrrrrrr
rrrrrrrrrrrrrrrrrrrrrrrrrrrrrrrrrrrrrrrrrrrrrrrrrrrrrrrrrrrrrrrr
