))^^^^^)^^^^^^^^^^^^^^^^^^----^^^^^^^^))))))-^^^^^^^---))))))))
)^^^^^^^^^)))^^^^^^^^^^^^^----^^^^^^^^^)))))))^^^^-----))))))))
^^^^^^^^^)))))^^^^)))^^^^^^---^^^^^^^^^^^)--)-^^^---------^^^^)
^^^^^^^^))))))^^^^))))^^^^^^---^^^^^^^^^^))---^^^-----)--^^^^^^
^^^^^^^)))))))^^^^)))))))))^)))))^^^^^^^^))----^------)-^^^R^^^
^^^^^^))))))))^^^^)))))))))^))----^^^^^^^))-----------^^^^R^^^^
^^^^^))))))))^^^^^^))))))))^^-----^^^^^^^))---------^^^^^R^^^^^
^^^^^)))))))^^^^^^^^))))))^^^-----^^^^^^^))))))-^^^^^^^^^^^^^^^
^^^^)))))))^^^)^))))))))))^^^^---^^^^^^^^----))^^^^^^^^^^^^^^^^
^^^^))))))^^^)))))))))))))^^^^^^^^^^^^^^^---)))^^^^^^^^^^^))^^^
^^^)))))))^^^)))))))))))))^^^^^^^^)))^^^^---))^^^^^^^))))))))^^
^)))))))))^^^)))))))))))))^^^^^^^)))))^^^---))^^^^^^^^)))))))))
)))))))))^^^^)))hh)))))))))^^^^^^))))))^))))))^^^^^^^^^))))))))
))))))))^^^^^)))^^)))))-))))^^^^^^))))))))))))^^^^))^^^^^^^))))
)))^^^^^^^^^)))h^^))))-))))-)^^^^^^^))))))))^^^^^))))^^^^^^^^))
))^^^^^^^^)))))h)))^)))-)--)))^^^^^^^))))))^^^^^^))))^^^R^^^^^)
--^^^^^^^))))))))))^^)))---)))))^^^^^^))))^^^^^^))))))^^^^^^^^)
---^^^^^^^))))))))^^^^))))))))))))^^^^^))^^^^))))))))))^^^^))))
---^^^^^^^^^))))))^^^^)))))))----)^^^^^^^^^^))))))))))))))))---
---^^^^^^^^^^)))))^^^^)))))-)----))^^^^^^^^^^))))))))))))------
--)^^^^^^^^^^)))))^^^^)))))))----))^^^^^^^^^^^)))))))))))------
))^^^^^^^^^^^^)))^^^^))))))))----)))^^^^^^^^^^^^)))))))))------
))^^^^RRRRR^^^^^^^^^^))))))))----))))^^^^^^^^^^^^^)))))^)------
))^^^^RRRRR^^^^^^^^^^)))))))))---)))))^^^^^^^^^^^^))))^^)))))--
))^^^^^RR^^^^^^^^^^^^))))))))))-----)))^^^^^^^^^^^^^^))))))))))
))^^^^^^^^^^^^)))))^^)))))))--------)))^^^^^^^^^))^^^))))))))))
))^^^^^^^^^^^))))))^^)))))))--------)))))^^^^^)))^^^^^)))))^)))
))^^^^^^^^^^^)))))))))))))))--^^----h))))^^^^^)))^^^^^))))^^^))
)))))))))^^^^^))))^^))))))))))-)----h)))))^^^^)))^^^^^))))^^^))
))))))))))--^^^))^^^))))))))))))----hh))))^^^^---^^^^)))))^^^^)
))))))))-----^^^^^^^)))))))))))))-----h)))^^^^-----)))))))^^^^)
))))))))------^^^^^^)))))))^^)))------h)))^^^^------)))))^^^^^^
)))))---------^^^^^^))))))^^^^))-------))^^^^^------)))))^^^^^^
)))))--------^^^^^^^))))))^^^^^)-------)^^^^)))-----))))^^^^^^^
))))))-------^^^^^^)))))))^^^^^^^-----^^^^))))))----)))^^^^))^^
)))))))))----^^^^^)))-))))^^^^^^^-^^-)^^^))))))---)^^^^^^))))))
))))))))))----^^^)))))))))^^^^^^^-^^-)^^)))))))---^^^^^))))))))
))))))))))-----))))))))))^^^^^^^-----))))))))))----^-----))))))
))^^^)))))------))))))))))^^-------))-)))))))))----------))))))
))^^^)))))-^----)))))))))-------))))---)))^^)))----------))^)))
)^^^^^)))))^^---)))))))))-------))))----)^^^)))----------))))))
))^^^))))))))^)))))))))))--^----))))----^^)))))----------))))))
))))))))))))))))))^)))))))^^^--)))))----))))))))))))------))-))
)))))))))))))))))^^)))))))^^^)))))))---)))))))))))))))---------
))hhhh)))hh---))))))))))))^^^^))))))---^)))))))))^^))))--------
))hhhhhhhhh----)))))))))))^^R^^^))))))^^^))))))^^^^^))))))-----
))hhhhhhhh------))))))))))^RRR^^^^)))^^^^^)))^^^^^^)))))))))---
))hhhhhhh--------))))))))^^RRRR^^^)))^^^^^))^^^^^^^))))))))))))
))hhhhhhh--------))))))))^^R^^^^^)))))^^^^^^^^^^^^)))))))))))))
)))))-)-h--------))^^^)^^^R^^^^))))))))^^^^^^^^^^^)))----))))))
))))----))h----))^^^^^^^^^^^^))))))))))))^^^^^^^^)))------)))))
))---------)))))^^^^^^^^^^^^^))))))))))))^^^^^^^^)))-----))))))
))----------)))))^^^^^^^^^^^)))hh)))))))^^^^^^^^))))---))))))))
)-----------)))))---^^^^^^^^^--))))))))^^^^^^^^^^))))))))))))))
))------))))-))------^^^^^^^^---))))))^^^^^^^^^^^^)^)))))))))))
))^^---h)))^)))------^^^^^^^^---)))^^^^^^^^^^^^^^^^^^^^^)))))))
)^^^)))))))^^))------^^^^^^^^---))^^^)))^^^^^^^^^^^^^^^^)))))))
^^^^^)))---^^^)------^^^^^^^^^--))^^))))))^^^^^^^^)))^^^)))))))
^^^^^-)----^^^^^)----^^RR^^^^^)))))))))))))^^^^^^)))))^^^))))))
^^^^--)----)^^^^)----^^^^^^^^^))))))))))))))^^^^---))))^^))))))
------)------))))))---^^^^^))))))))))))))))))))----h)))))))))))
------)------)))))))----))))))))))----)))))))))-----h))))))))))
)-----)------))))hhh----))))))))))))-)-h)))))))---hhhhh))))))))
