%(%(%(^(^(%(%(^(^(%))))))%((^(%(%(^(R^^(^(^((%))))%(^(^(^()))%rr
)))))%^^^%)))%^^^^^%)))))%^^^%---%%%(^^^^^^%%%)))$%%%^^^^%))))rr
))))))%^%)))))%^^^(^%))))%^^%-----))%^^^^^%))%%%)))))%^^%)))))rr
))))))%^%)))))%^^^^^^%)))%^^%-----)))%^^^%))))%%))))))(^%)))))rr
))))))%%)))))))%^^((^%)))%^^%))))))))%^^^%)))))%))))))%^%)))))rr
))))))%%)))))))%^^((^^%%%^%%%%-))))))%^^^^%%)))%)))%%%^^%)))))rr
)))%%%^^%)))))%^^^^^^^(^^%)))%%%%))))%^^^^^^%%%%%%%^(^^^%)))))rr
)%%^^^^^^%))))%^^^^^^(^^%-----%%%----%^RR^^^^^%)%^^^(^^%))))))rr
%^^^^^^^^^%))))%%%%%%%%%--+-+------+-%^^R^^^^%)))%%%%%%)))))))rr
^^^^^^^^^^^%))---)---))--++-+++++++--%^^^^^^%)))))))))))))))))rr
^^^^^^^^^^^%---+---+-))-+-+-++++++++-%^^^^^^%)))))))))))))))))rr
^^^^^^^^^^^^%-----+--))-------++++++-)%^^^^^%)))))))))))))))))rr
^^^^^^^^^^%%^%-+----))))))-$)----++--))%%^^^^%))))))))))))))))rr
^^^^^^^^%%))%%---+-)))))%%%^%%))----)))))%^^R^%)))))))))))))))rr
^^^^^^%%))))--$----))))%^^^^^^%%%%%%%))))%^RR^^%))))))))))))))rr
^^^^%%))))))--%%)))))))%^^^^(^^^^^^^^%)))%^RrR^^%)))))))))))))rr
^^^%-----)))))%^%)))))))%%^^^^^^^RR^^%)))%^RrrR^%)))))))))))))rr
^^%--+++-)))))%^%)))))))))%%^^RRRR%%%^%)%^^RrrR^^%)))-------))rr
^%--+++--)))%%^^^%%)))-)))))%^RrR%)))%%%^^^^RrrR^^%)--+-+-+-))rr
%)--++++-))%^^^^^^^%)----)))%^^R^%)))--%^^^^^RrrR^%)-+-++-+-))rr
)))--+++--%^^^^^^^^^%-+-))))%^^^%)))---%^^^^^^RrR^%)--++----))rr
)-)--+++--%^^^^^^^^^%---))%%^^^^%))))--%^^%%%^RR^^%))--+-))-))rr
))----++--%^^^^^^^^^%-+-)%^^^^^^%))))--%^%)))%^^^%))))---)))))rr
)--+--++-$^^^^^^^^^^%---)%^^^^^%)))))))%%))))%^^^%))))))))))))rr
--+++----)%%^^^^^^^^%-+--%^^^^^%))))))%^%)))))%^%)))))))))))))rr
-+++--))))))%^^^^^^%--++-)%^^^%)))))))%^%))))))%%)))))))))))))rr
+----))))))))%^^^^^%--++-)%^^%))))))%%^^^%))))))))))))))))))))rr
+++-))))))))))%^^^^^%-+--)%^%))))))%^^^^%)))))))))))))))))))))rr
+++-)))))))))))%%%%%%---))%%)))))))%%^^^%)))))))))))))))))))))rr
----))))))))))))))))%%)))$)-----)))))%^^%)))))))))))))))))))))rr
--%%%))))))))))------%%%%))-+++-))))))%%))))))))))))))%%))))))rr
)%^^^%%))%%%)))-+-++-)%^%))--++-))))))))))))))))))))))%^%)))))rr
)%^^^^^%%^^%)))-++-+--%%)))-----))))))))))))))))))))))%^%)))))rr
)%%%^^^^^^^^%))--++++-)$))))))))))))))))))))))))))))))%^%)))))rr
))))%^^^^^^^%)))-++---)))))))))))))))))))))))))))))%%%^^%)))))rr
)))))%^^^^^^^%)----+-))))))))))))))))))))))))))))))%^^^^%)))))rr
))))))%^^^^^^%))))---))))))))))))))))))))))))))))))%%^^^%)))))rr
)))))))%%%%%^^%%)))))))))))))))))))-----)))))))))))))%^^%)))))rr
))))))))----%^^%))))---))))))))))))-+-+-))))))))))))))%%))))))rr
))))))))-++--%%%))---+-))))---)))))-+----)))))))))))))))))))))rr
%%))))))--+---))))-++--)))--+--))-)--+-+-))))---))))))))))))))rr
^%))))%%%--+-)))))-+--)$))--+--)))))-----))))-+-))))))))))))))rr
^%))))%^^%-+-)))))---)%^%%%--+-)))))-))))))))---))))))))))))%%rr
%)))-))%^%-+-)))))))%%^^^^^%---))))))))))))))))))))$)))))))%^^rr
%))-)))%^%---))))))%^^^^^^^%%)))-----)---)))))))))%^%)))))%^^^rr
))))))))$)%%-))))))%^^^^^%%)%%))-+++---+---)))))))%^^%)))%^^^^rr
----)))))%^^%)))))%^^^^^%))))%%%--+++---+--)))))))%^^^%%%^^^^^rr
%-+-)))))%^^%)))))%^^^^%))----%%)-++--)---))))))))%^^^^^^^^^^^rr
%-+--))))%%%%)))))%^^^^%)))---%^%----))))))))))))))%%^^^^^^^^^rr
%-++-))))))))))))))%%^^^%%%%%%^^%)))))))-))))))))))))%^^^^^^^^rr
%----))-)))))----))))%^^^^^^^^^^^%)))))))%%%%)))))))))%^^^^^^^rr
))))))))))))--++-))))%^^^^^^^^^^^^%%%%%%%^^^%)))))))))%^^^^^^^rr
))))))))))))-++--)))))%^^^^^^^^^^^^%^^^^^^^^^%)))))))))%^^^^^^rr
))))))))))))---+-)))))%^^^^^^^^^^^%)%^^^^^^^%--))))))))%^^^^^^rr
)))))))))))%%)-------)%^^^%%^^^^^%)))%^^^^^%---))))))))%^^^^^^rr
))))))))))%^^%%---++-)%^^%))%^^^^%))))%^^%%----))))%%%)%^^^^^^rr
))))))))))%^^^^%------)%%))))%^^^%))))%%%---+-))))%^^%))%^^^^^rr
)))))))))))%%^^^%%--)))))))))%^^^^%)))))---+--)))%^^^%)))%^^^^rr
)))---)))))))%^^^^%%))-))))))%^^^^^%%)))--+--%%%%^^^%)))))%^^%rr
))--+--)))))))%^^^%%%---)))))%%%^^^^%))))---)%%%^^^^%)))))%%%)rr
))-+++--)))))))%%%----+--)))---)%%%%%)))))))))))%%%%%)))))))))rr
)--++++-))))))))----++++--)--+-)))))))))))))))))))))))))))))))rr
rrrrrrrrrrrrrrrrrrrrrrrrrrrrrrrrrrrrrrrrrrrrrrrrrrrrrrrrrrrrrrrr
rrrrrrrrrrrrrrrrrrrrrrrrrrrrrrrrrrrrrrrrrrrrrrrrrrrrrrrrrrrrrrrr
