^^^^^^^^^^^^^)))--------------))))))))))^^^^^^^^^))^^))))^^^^^^
^^^^^^^^^^^^^))))-----------)))))))))))^^^^^^^^-)))^^^^^^^^^^^^
^^^^^^^^^^^^^))))))^^^^^----)))))))))^^^^^----)))))^^^^^^^^^^^R
^^^^^^^^RR^^^^))))^^^^^^^^^^^^^))^^)^^^^^)-----)))))^^^^^^^^^^^
^^^^^^^^^^^^^^))))^^^^^^^^^^^^^^^^^^))^^))))))-))))))^^^^^^^^^^
^^))^^^^^^^^^^---)))^^^^^^^^^^^^^^^^))))-))))))))----))^^^^^^^^
^))))^^^^^^^-----))-)^^^^^^RRRRR^^^^-))))))))))))------))^^^^^^
^))))))^^^)------))---^^^^^RRRRR^^^----))))^^))))-------)^^^^^^
)))))))))))------))---^^^^^^^^^^^^^^---)))^^^^^)))------)^^^^^^
^))))))))))^^^^^-)----^^^^^^^^^^))^^^--)))^^^^^^^^^-----^^^^^^^
^^^^^)))))^^^^^^^))))-^^^^^^^)))))^^^)))))^^^^^^^^----^^^)---^^
^^^^^)))))^^^^^^^)))))^^^^^^^)))))^^^^)))^^^^^RR^^-----^))----^
^^^^^^)))^^^^^^^^)))-)^^^^^^^^)))^^^^^^))^^^^^^^^^---)))))----)
^^^^^^^^^^RRR^^^^^))))^^^^))^^^^^^^^^^^^^^^^^^^^^---))))))----)
^^))^^^^^^RRR^^^^^))))^^^))))^^^^^)))^^^^^))))^^----)))))^^^^^^
^)))))^^^^RRR^^^^)---^^^^)))))^^^^))))^^^^)))))-----)))))^^^^^^
)))))))^^^^^^^^^^----^^^^)))))^^^)))))^^^))))))---)))))))^^^R^^
)))))))))^^^^^^^^----^^^^)))))^^^--))--^^))))))))-))))))))^^^^^
)))))))))))))^^^------^^^)))))^^^))))--^^^^^^))))))))))))))^^^^
)))))))))))))))^------^^^)))))^^^)-))---^^^^^)))))))))))))))))^
)))))))))))))))))---))))))))))^^^)))))---^^^^))))))))))))))))))
))))))^^^))))))))))hh)))))))))))))))))----^^^----))))))))))))--
)))))^^^^^))))))))))hh))))))))))))^^))----^^^----))^^)))))))---
)))))^^^^^))))))))))hhhh)))^^^^^^^^^^))-)-^^^----)^^^^)))))----
)))))^^^^)))))))))))hhhh)))^^^^^^^^^^)))))^^^---)^^^^^)))))----
^^))))^^^))))))))))hhhhh))))^^^^^^^^)))))^^^^^-))^^))))))))----
^----)^^^)))hhhh---hhhhhh))))^^^^^)))))))^^^^^)))))))))))))))-^
^----)^^^)))hhhh-----hhhhh))))^^^^))))))^^^^^^^))))))))))))))^^
------^^^))))hhh------hhhhh)))^^^))))))))^^^^^^^))))hhh)))))))^
------^^^)))))hh------hhhh)))))^))))))))))^^^^^^)))))))))))))))
------^^^^^))))h------hhh))))))))))))hh)))^^^^^^^)----)))))))))
------^^^^^^)))h----hhhh))---))))))))))))-^^^^^^^)----)))))))))
)-----^^^^^^^)))hhhhh))))-----)))))))))))^^^^^^^^)-----))))))))
)-----^^^^^^))))))hh))))------))))))))^^^^^^^^^^^)-----))))))))
))----^^^^)))))))))h))))------)))))--^^^^^^^^^^^^)))---^^^^))))
-)----^^^^))))))))))))))-----)))))^^--^^R^^^^^^^^)))-))^^^^^^))
))----^^^)))))))))))))))------))))^^--^^^^^^^^^^^))))))))^^^^^)
))----^^^^))))))))))))))------)))-----^^^^^^^^^^^^))))))))^^^^^
)-----^^^^^^)))))))))))))------^^-----^^^^^^^^RR^^^^))))))^^^^^
))---))^^^^^^))))^^^^)))-------^^------^^^^^^^RRR^^^))))))^RR^^
))))))))^^^^^^^^^^^^^)))-------))))---))))^^^^^R^^^^))))))^^^^^
)))))))))))^^^^^^^^)))---------))))))-))))^^^^^^^^^^))))))^^^^^
-)^^)))))))^^^^^^^))))---------)))))--)))))^^^^^^^^^))))))^^^^^
-^^^^))))))^^^^^^)))))-----^---)))^^^---))^^^^^^^^^^^)))))^^^^^
^^^^^^))))^^^^^^))))))---^^^^^)))^^^^----)^^^^^^^^^^^^))))^^^^^
-^^^^^)--^^^^^^^))))))--^^^^^^^^^^^^^^--)^^^^^^^^^^^^^^^^^^^^^)
---------^^^^^^))))))))^^^^^^^^^^^^^^^^^^^^^^^^^^^^^^^^^^^^^^^)
--------^^^R^^^))))))^^^^^^^^^^RR^^^^^^^^^^^^^^^^^^^^^^^^^^^^^)
--------^^^RR^^))))))^^^^^^^^^^RRR^^^^^^^^^^^^^^^^^^^^^^^^^^^^)
------))^^^^^^^^)))))^^^^^^^^^^RRR^^^^^^^^^^^^))))^^^^^^^^^^^^)
------)))^^^^^^^))))))^^^^^^^^RRR^^^^^^^^^^^^)))))^^^^^^^^^^^^)
)-)---)))^^^^^^)))))))^^^^^RRRRR^^^^^^^^^^^^^))))))^^^^^^^^^^))
)))))))))^^^^^^))))))))^^^^^^^^^^^^^^^^^^^^^^)))))))))))))^^^))
))))---))^^^^^))))))))))^^^^^^^^^))^^^^^^^^^))---))))))))))^^))
))))-----^^^^^)))))^)))))^^^^)))))))^^^^^^^^)----))))))---)^^))
))^^^---)^^^^^)))^^^^^)))^^^^))))))))^^^^^^^------hhhhh---)))))
))^^^^---^^^^^))^^^^^^^))^^^)---)))))))^^^^^^-----)hhh-----))))
))^^^---))^^^^^^^^^^^^^^^^^-----))))))))))^^^^----))h-------)))
))^^^---))^^^^^^^^)))^^^^^-----^))))))))))^^^^^--)))--------)))
))^^^))))-^^^^^^)))))-^^^------)))))))))))^^^^^)))))--------)))
)))))))))---))))))------))-----)))))))))))))))))))))------)))))
))))))))----))))))------)))))))))))))))))))))))))))))----hh))))
))))))))----)))))h------)hhhhh)))hhhhhhh)))))))))))))---hhhhhhh
