))^^^^^^^^^^^^)))))))))))))^^^^^^^))))^^^^^^^^^)))))))))--)))))
)^^))))))----))))))))))))))^^^^^^^^^)))^^^^^^^^)))))))))----)))
)))))))))-----)))))^))))))^^^^RR^^^^^^)^^^^^^^^))))))))-----)))
))))))))------)))))^^)))))^^^^RRR^^^^^^^^^^^^^^^^^^^^))-----)))
))))))))-------)-)-^^^)))^^^^^^RR^^^^^^^^^^^^^^^^^^^^^)----))))
))))))))----)))-----^^^^^^---^^^^^^)^^^^^^^^^^^^^^^^^^^----))))
))))))))h---))------)^^^^-----^^^^)))^^^^^^^^^^^^^^^^^^^---))))
)))))))))))))))-----))^^-------^-)))))^^^^^^^^^^^^^^^^^^---))))
)))))))))))))))-----))))--------))))))^^^^^^^^^^^--))))----))))
)))))))))))))))))----))))--------)))))^^^^^^^^)----))))))))))))
)))))))))))))))))---))))))^^----))))))^^^^))))-----))))))))))))
))^^^)))))))))))))))))))))^^^--)))))))^^^))))-----)))))))))^^))
))^^^)))))))h))))))))))))^^^^^)))))))^^^^))))-----))))))))))^))
))^^^^))))))hh))^^))))))))^^^^)))))^^^^^^^))-----))))))))))))))
))^^^^^^)))))hh)^^)))))))))^^^))))^^^^^^^^))------)))))))))))))
))^^^^^^))))))hh)))))))))))))))))^^^^^^^^)))------)))))))))))))
)^^^))))))))))hh))))))-))))))))))^^^^^^^^))))-----))))))-))))))
)^))))))))))))hh)))))----))^^)))))^^^)^)))))))----)))))))))))))
)))))))))))))----)^^^----)^^^))))))))))))))^)))))))))))))))))))
)))))))))))^)-----^^^----^^^^^))))))))))))^^^))))))))))))))))))
))))))h))))^^----^^R^^---^^^^^-)))))^)))^^^^^^)))))))))))))))))
)))))))))))^^----^^^^^^^^^^^^^)-)))^^^^^^^^^^^)))))))))))))))))
))))))))))))^---^^^^^^^^^^^^^--))-^^^^^^^^^^)))))))))))))))))))
))))))))))))))---^^^^^^^^^^^^--))^^^RRRR^^^))))))))))))))))))))
)))))))))))))))---^^^)---^^^^--))^^^^^R^^^)))))))))))))))))))))
)))))))))^^^)))---)-))---)^^^^))^^^^^^^^^--))))))))))))))))))))
)))))))^^^^^)))-----))))))^^^^^^^^))))^^--)))))))))))--)hhh))))
))))))^^^^^^^))-----))))))^^^^^^^)))--------))))))))---)))h))))
))))))))^^^^^))-----)))))^^^^^^^))))--------))))))))---))))h)))
))))))------)))))---))))^^^^^^^)))-)------^^))))))))---))))))))
))))))------)))))-^^^^^^^^^^^^))----)---^^^^^^)))))))--))-))h))
))^^---------)))^^^^^^^^^^^^^^)--------^^^^R^^^))))))))))))))))
)^^^^----))))))))^^^^^^^^^^^^^^)-------^^^RRR^^))))))))))))))))
)^^^^^---))))))))))))))^^^^^^^^^^^------^^^RR^^^)))))))))))))))
)^))-^^^-))))))))))))))))^^^^RR^^^------^^^RR^^^)))))))))))))))
))))))^^))-))))))))))))))^^^^^RR^^^^)---^^^^^^^^))))))))))))^))
))))))))))))))))))))))))))^^^^^^^)^^)---^^^^^^^^^))))))))))^^^^
^^)))))))))))))))))^))))))^^^^^^^))))))^^^^^^^^^^)))))))))^^^^^
^^^))))-))^^^)))))^^^))))^^^^^^^^)))))^^^^^^^^^^^))))))))))^^^^
^^^))))---^^^)))))^^^^)))^^RR^^^^))))^^^^^^^^^^^^^)))))))))^^^^
))))))----^^^^)))^^^^^^)^^RR^^^^-----^^^^^---^^^^^^))))))))))))
))))))----^^^^)))^^^^^^^^^R^^^^^-----^^^^^--)^^^^^^^))---))))))
)))))))----^^^---)))^^^^^^^^^^^)------^^^)))-^^^^^^^-----))))))
)))^)))))---^----))))^^^^^^^^^^)------^^^)))))^^^^^^^----)))---
)))^))))))--------))))^^^^^^^^^^------^^^)))))^^^^^^^----))----
)))^^)))))))--------))^^^^^^^^^^^----^^^^)))))^^^^^^^^--)))----
)))^^)))))))---------)^^^^^R^^^^^^^^^^^^^^^^^^^^^^)))^^^^^^^---
)))^^)))))-----------))^^^RRR^^^^^^^^^^^^^^^^^^^^)))))^^^^^^---
))^^^))))----))--------^^^^^^^^^^^^^^^^^^^^^^^^^^)))))^^^^^^---
))^^^))))----))--------^^^^^^^^)))^^^^^^^^^)^^^^^^))))^^^^)))))
))^^^))))----)^^-------^^^^))))))))^^^R^^^)))^^^^^^^^^^^^))))--
))^^^))))---))^^^------^^^))))))))^^^^^^^^))))^^^^^^^^^^)))))--
))^^^))))---))^^^------^^)))))))))^^^^^^^)))))^^^^^^^^^^))))---
)))^))))))))))^^^)----^^^^))))))^^^^^^^^))))))^^^^^^^^^^))))---
)))))))))))))^^^^^)-)^^^^^^^^^^^^^^^^^^)))))))^^^^^)^^^^^^^)---
))))--)))))^^^^^^^^))^^^^^^^^^^^^^^^^^))))))))^^^^)))^^^^^^^^--
)))----))^^^^^^^^^^)))^^^^^^^^^^^^^^^^))))))---^)----^^^^^^^^^-
^^^--^^^^^^^^^^^^^))---)))^^^^^^^^^^^^))))))----)----)^^^^^^^^^
^^^^^^^^^^^R^^^^^)))----))^^^^^^^^^^^--)))))----------^^^^^^^^^
^^---^^^^^RR^^^^))------))^^^^^^^^^^^--))))------)))))^^^^^^^^^
))---)^^^^^^^^^)))------))^^^^))))))---))))------))))))))----)^
)))))))))))^))))))------)))))))))))))))))))-----))))))))-----))
))))))))))))))))))------)))))))))))))))))))))))))))))))))---)))
