)%(^(%))))))))))))))))))))%%%%%(%(^(^())))))))%^(^((^%)))%^^^%rr
))(^())))))))))()%%))()))))))))))%^^^%))))))))%(^^(%^(%(%^^%%)rr
))(%)))))))))$%%%^^%)()))())))))))%^^^%)))))))%^(%))%^^^^^%)))rr
))))))))))))))%^^^^^%))))))))))))))%^(^%))))))%%)))))%^((%))))rr
)))))))))))))))%%%(()))))))))))))))%^(^^%%)))))))))))%^^%)))))rr
))))))))))))))))))))))))))))))))))))%^^^^%)))))))))))%^^%)))))rr
))))))))))%%%))))))))))))))))))))))))(^^^%)))))))))%%^^^%)))))rr
)))))))))%^^%))))))))))))))))))))))))%^^^%))))))))%^^^^%%)))))rr
)))))))))%(^())))))))))))))))))))))))%^^(%))))))))%^^%%)))))))rr
$)))))))))%^())))))))))))))))))))))))%^^^%)))))))$^%%))))))%%%rr
%)))-)))))%(%)))))))))))))))))))---))%^^^%))))))))$)))))))%^^^rr
%)))-))))))%%)))))))))))))))))))-+---%^^%))))))))))))))))%^^^^rr
)))-))))))))))))))))))))))))))))-+++-)%%%)))))))))))))))%^^^^^rr
))--)))))))))))))))))))))))))))--++--)))))))))))$)))$%%%^^^^^^rr
))%%%))))))))))))))))))))))))))-++++-))))))))))$%))))%^^^^RR^%rr
))%^^%)))))))))))))))))))))))))--+-+-))))))))))))))))%^^^RRR^%rr
)$%^^%))))))))))))))))))))))))))-----)))))$))))))))))%^^^R^^^%rr
)))%%%)))))))%%%%)))))))))))))))))))))))%%))))))))))))%^^^%%%)rr
)))))))))))))%^^%)))))))))))))))))))))$%^%))))))))))))%^^%))))rr
)))))))))))))%^(%))))))))))))))))))))))%%)))))))))))))%^%)))))rr
))))))))))))))%%)))))))))))))))))))))))))))))))))))))))%%)))))rr
)))))))))))))))))))))))))))))))))))))))))))))))))))))))%%)))))rr
)))))))))))))))))))))))))))))))))))))))))))))))))))))))%^%%%))rr
)))$)))))))))))))))%%)))))%%))))))))))))))))))))))))))))%^^^%)rr
)%%%)))))))))))))%%^%%)))%%%))))))))))))))))))))))))))))%^%^^%rr
%%%)))))))))%%%%%^%%)%%%%%)))))))))))))))))))))))))))))))$)%%%rr
%))))))---%%^^^^^%))))%^%)))))))))))))))))))))))))))))))))))))rr
%))))))---%^^^R^^%))))%%%)))))))))))))))))))))))))))))))))))))rr
%)))))---%^^^^^%%)))))))))))))))))))))))))))))))))))))))))))))rr
^%)))))-%^%%%%%)))))))))))))))))))))))))))))))))))))))))))))))rr
^^%%%%%%^%)))))))))))))))))))%%%%%)))))))))))))))))%%%%%%%%%%%rr
^^^^^^^^%))))))))))))))))))))%^^^^%)))))))))))))))%^^^^^^^^^^^rr
^^^^^^^^%))))))))))))))))))))%^^^^%))))))))))))))%^^^^^^^^^^^^rr
^^^^^^^^^%)))))))))))))))))))%^^^%)))))))))))))))%%%%^^^^^(^^^rr
^^^^^^^^^^%%%%%%)))))))))))))%^^^%)))))))))))))))))))%^^^^^^^^rr
^^%%%^^^^^^^^^^%))))))))))))))%^%)))))))))))))))))))))%^^^^^^^rr
^%)))%%%%%%%%%%)))))))))))))))%^%)))))))))))))))))))))%^^^^^^^rr
%)))))))))))))))))))))))))))))%%))))))%%%)))))))))))))%^^RRR^^rr
))))))))))))))))))))))))))))%%%%)))))%^^^%%)))))))))))%^RrrR^^rr
)))))))))))))))))))))))))))$%%)))))))%^^^^^%))))))))))%^RRRRR^rr
)))))))))))))))))))))))))))))))))))))%^^^^^%%)))))))))%^^^^^^^rr
))))))))))))))))))))))))))))))))))))))%^^%%))))))))))))%%%%^^^rr
%))))))))))))))))))))))))))))))))))))))%%)))))))))%%%))))))%%^rr
%))))))))))))))))))))))))))))))))))))))))))))))))%^^^%)))))))%rr
)))))))))))))))))))))))))))))))))))))))))))))))%%^RR^^%)))))))rr
))))))))))))))))))))))))))))))))))))))))))))))%^^RrR^^%)))))))rr
)))))))))))))))))))))))))))))))))))))))))))))%^^^RrR^^%)))))))rr
)))))))))))))))))))))))))))$)))))))%%))))))))%^^RrrR^^%)))))))rr
)))))))))))))))))))))))))))%%)))))$%^%%))))))%^RrrR^^%))))))))rr
)))))))))))))))))))))))))))))$)))$))%^^%%%%%%^^RrrR^%)))))))))rr
))))))))))))))))))))))))))))))$%%))))%^^^^^^^^^RrR^^%)))))))))rr
)))))))))))))))))))))))))))))))$))))))%^^^^^^^^RR^^^%))))))%%%rr
--))))))))))))))))))))))))))))))))))))%%^%^^^%^^^^^^%)))))%^^^rr
+--)))))))))))))))))))))))))))))))))))))$)%^%)%%%^^^%)))))%^^^rr
++-)))))))))))))))))))))))))))))))))))))))%^%))))%^^^%))))%^^^rr
+--)))))))))))))))))))))))))))))))))))))))%^%))))%^^^%)))%^^^^rr
-+-))))))))))))))))))))))))))))))))))))))%^^%))))%^RR^%))%^^^^rr
---)))))))))))))))))))))))))))))))))))))%^^%))))))%^^^^%%^^^^^rr
)))))))))))))))))))))))))))))))))%%%%%%%^^^%))))))%^^^^^^^^^^^rr
))))))))))))))))))))))))))))))))$^^^^^^^%%%%))))))%%%%%%%%%%%%rr
)))))))))))))))))))))))))))))))))%%%%%%%))))))))))))))))))))))rr
))))))))))))))))))))))))))))))))))))))))))))))))))))))))))))))rr
rrrrrrrrrrrrrrrrrrrrrrrrrrrrrrrrrrrrrrrrrrrrrrrrrrrrrrrrrrrrrrrr
rrrrrrrrrrrrrrrrrrrrrrrrrrrrrrrrrrrrrrrrrrrrrrrrrrrrrrrrrrrrrrrr
