)))))))))))))))-)))--+--+++----+-))$))))))))))%%))))))))%^^^(%rr
)))))))))))))----)))----+++--++--))))))))))))))))))))))))%^^^(rr
)))))))))))))-++---))---++-----+-)))))))))%%%))))))))))))%^^((rr
)))))))))))))--+-)))-)-+---))----))))))))%^^%))))))))))))%(R^(rr
))))))))))))))-+-))))----)))))-)))))))))%^^^^%)))))))))))%^R^^rr
))))))))))))))---)))))))---))))))))))))%^(((^%))))))))))%^^R^^rr
))%%)))))))))))-))))))))-+()-))$))))))%(^^^^^%)))))))))%^^^(^^rr
)%^^%))))))))))))))))))--+--))%^%%)))%^^(^^^^%)))))))))%^^^^^^rr
%^^^%)))))))))))))))))--+++---%^^%)))%^^^^(^%)()))))))%^^(^^^^rr
%^^^%))))))))))))))))))--+-+-)%^^%)))%^^^^^^%))))))))%^^^^%%%%rr
%^^^%)))))))))))))))))))-----)%^^%)))%^^^^^^%)))))))%^(R^%----rr
%^^^%))))))))))%%)))))))))))))%^%)))))%%^^^^%)))))%%^((R^%--+-rr
)%%^^%))))))))%^%)))))))))))))%^%)))))))%%^^^%)))%^^^^^^%--+--rr
)))%%%))))))))%^%))---%%%))---%^%)))))))))%^^%)))%^^^^^%))---)rr
))))))))))))))%^%))--$^(%))-+-)%%)))))))))%^^^%%%^^^^^^%))))))rr
))))))))))))))%^%))---%^%))---)%%))))))))%^^^^^^^^^^^^%)))))))rr
))))))))))))))%^%))---%(%)))-))%%))))))))%^^%^%%%%%%%%%)))))))rr
))))))))))))))%^%))-+--)-))))))))))))%%%%^%%)$)))-))))))))))))rr
)%%%%)))))%%%%^^%---++-))))))))))))))%^^^%))))-----)))))))))))rr
%^^^^%)))%^^^^^^%----+-)))))))))))))-%^^^%))))-+++-)))))))))))rr
^^%%%))))%^^RRR^^%--+--)))))))%%%)))--%^%)))))-----)))))))))))rr
%%))))))))%^RrrR^^%----))))))%^^%)-----$))))))))))))))))))))))rr
))))))))))%RrrrrR^^%%--))))))%^^^%-+++--))%%%)))))))))))))))))rr
)))))))))%^RRRRRRRR^^%)))))))%^^%)--++-)%%^^^%))))%%))))))))))rr
)))))))))%^^^^^^^^RR^%)))))))%^^%))----%^^^^^^%))%%%))))))))))rr
))))))))%^^%%%%%%^^R^%))))-)))%%)))---%^^^%%%%^%%%))))))))))))rr
))))))%%^^%))))))%^^^%)))))))))))))-+-%^^%))))%%))))))))-))---rr
)))))%^^^%)))))))%^^^%)))))))))))))---%^%))))))))))))-------+-rr
)))))%^^%))))))))%^^^%)))))))))))))---%%)))))))))))))-++++-+--rr
)))))%^^%))))))%%^^^%%))))))))))))))---)))))))))))))---++-+--+rr
))))))%^%)))))%^^^%%))))))))))))))))))))))))))))))))))---+++++rr
)-))))%^%)))))%^^%))))))))))))))))))))))))))))))))))))))--++++rr
)-)-))%^%)))))%%%))))))))))))))))))))---))))))))))))))))------rr
-----))$))))))))))))))))))))))))))))--+--))))%%%%)))))%%%--)))rr
)-+--------))))))))))))))))))))))))--+++-))))%^^%))-)$^^^%))))rr
)---+--++-%%%))))))))))))))))))))))-++++-))))%^^%))---%^^%))))rr
)))-+---+-%^^%)))))---)))))))))))))--+++--))))%%%)--+-%%%)))))rr
)))--+----%^^%)))))-+----))))))))))-+-+--))))))))--++--)))))))rr
))))-+-)))%^^^%)))-----+-))$)))))))-----)-)-)))))------)))%%%)rr
-)))---)))%^^^^%)))--++---%^%)))))))))))))-----))-%%%--))%^^^%rr
--)))))))%^^^^^^%))-+-+--%^^%)))))))))))))-+++-))$%%%%)))%^^^^rr
%%)))))))%%%%^^%)))-+---%^%%))))))))))%%%%-----)))))))))$%%%%^rr
^^%%%%)))$)))%%%)))---$%%%)))))))))))$^^^%-+-))))))))))))))))%rr
^^^^^^%%))---))))))))))$))))))))))))))%^%--+-)))))))))))))))))rr
^^^R^^^%))-+-----)))))))))))))))))))))%%%-+--)))))))))))))))))rr
%^^^^^^%))--++++-)))))))))))))))))))))))-----)))))))))))))))))rr
)%^^^^^%)))---++-)-----)))))))))))----))---$-)))))))))))))))))rr
)%^^^^^%))))---+-))-++-)))))))))))-++--)))%^%)))))))))))))))))rr
)%^^^^^^%))))-++-)--++-)))))))))))--++-))%^^^%))))))))))))))))rr
)%^^R^^^^%)))----)-+---))))))))))))----))%%%%%)))))))))))----)rr
)%^^^^^^^%))))-)))-+--)))))))))))))))))))$--)$))))$))))))-++--rr
)%^^^^^^%)))))))))--+-))))))))-))))))))))-----)))$%%))))--+++-rr
)%^^^^%%)))))))))))---))))))))))))))))))--+-+-)))))%%))))-+++-rr
)%^^^%)))))))))))))))-)))))))))))))))))--+++--)))))))$)))-----rr
)%^^^%))))))))))))))))---))))))))))))))-+-+--)))))))))%%%%%%%)rr
)%^^^%))))))))))))))))-+-))$)))))))))))---+-))))))))))%^^^^^^%rr
%^^^^%)))))$))))))))))---)%^%%)))%%%%))))-+-)))))))))))%^^^^^^rr
^^##%^%))%%^%))))))))))))%^^^^%%%^^^^%))--+---)))))))))((^%%%^rr
^%---%%%%^^^^%))))))))))%^^^^R^^^^^^%^%%-++-+-)))))))))((%)))%rr
%----))%^^^^^%))))))))))%^^^^^RR^^%%)%%---+-+-)))))))))%%)))))rr
--+--)))%%%%%%))))))))))%%%%%%%%%%-))))---+++-))))))))))))))))rr
----))))-----)))))))))))))))))))----))))---+--))))))))))))))))rr
rrrrrrrrrrrrrrrrrrrrrrrrrrrrrrrrrrrrrrrrrrrrrrrrrrrrrrrrrrrrrrrr
rrrrrrrrrrrrrrrrrrrrrrrrrrrrrrrrrrrrrrrrrrrrrrrrrrrrrrrrrrrrrrrr
