)-++-)%^^^^^%)))))%%%))))))))))---++--%%))))--+--)%%))))))%^()rr
)----%^^^^^^^%)))$))))))))))))))-----%^^%)))-+--))%%)-----%^%)rr
))--%^^((^^^^^%%)))))))))%%%%%)))))--(^^^%))---)))%%)-+-+--%%)rr
)))%^^^^(^^^^^^%)))))))%%^^^^^%))))-)%^^(%))))))))%^%--+++-%))rr
))$%((%%%%%%%%%))))))))%^^^^^^^%)))))%^^%)))))))))%^%)-+++-%))rr
)))))))-----))))))))))%^^^%%%%^%))%%%^^^^%)))))))%^^()-++--%%)rr
)))))))-++--))))))))))%^^%))))%^%%^^^^RR^%)))))))%^^%)-+--%^%)rr
)))))))----)))))))))%%^^^%----)%^^^RRRrR^%)))))))%%%%)----%^%)rr
))))))))))))))))))))%^^^%---+-))%^^RrrrR^^%))))))))))))))%^%%)rr
)%%))))))))))))))))%^^^^^%----)))%^^RrrR^^%))))))))))$%%%^%))$rr
%^^%%)))))))))))))%^^^R^^%--)))))%^^^RRR^%))))))))))))%^^%))))rr
^^^^^%))))))))))))%^^^RR^%--))))))%^^^^^^%))))))))))))%^%)))))rr
%(^^^^%)))))))))))%^^^^^%)))))))))%^^^^^^^%)))))))))))%^%)))))rr
)%^^^^^%)))))---))%^^^^^%)--))))))%^^^^^^^^%))))))))))%(%)))))rr
)%^^^^^%)))---+--)%^^^^^%---))))))%^^^^^^^^^%)))))))))%^%)))))rr
%^^^^^^%)))-+-++-)%^^^^%--+--))))))%^^^^^^^^%)))))))))%%%)))))rr
^^^^^%%))--------)%%%%%)-+-+-))))))%^^^^^^^^^%))))))))--))))))rr
^^^^%))))--+-)))))))))))-----))))))%^^^^^^^^^^%))))------))%%%rr
^^^^%))))-++--)))))))))))))))))))))%^^^^^^%%%^^%%))-+-++--)%^^rr
^^^^%))))--))))))))))))))))))))))))%^^^^^%)))%^^%)--+++++-%^^^rr
^^^^^%))))))))))))))))------))))))%^^^^^^%)))%^^^%)--+++--%^^^rr
^^^^^^%%%%)))))))))))--+--+-)%%%%%^^^^^^%))))%^^^%))-----))%^^rr
^^^%^^^^^%)))))))))))-----+--%^^^^^^^^^^%))))%^^^%))))))))))%^rr
^%%-%%^^%)))))))))))---+---+-)%^^^^^^^^^%))))%^R^%)))))))))))%rr
%----)%%))))))))))----+------))%%%%%%%%%)))))%^R^%))))))))))))rr
)----)))))))))))))-+--+++-)))))))))))))))))))%^R^%))))))))))))rr
))%%))))))))---)))-++++--))-)))))))))))))))%%^^R^%))))$%%%%%))rr
)%^^%)))))))-+--))--+++-)))$)))))))))-))))%^^^RR^%)))))%^^^^%)rr
%^^%%---))))))))))))))))))%^%)))))))---))%^^^^R^^%))))))%%%^^%rr
^%%---+-)))))---)))-----)%^^^%)))))----)%^^^^^^^^%)))))))))%^^rr
%----+--)))))))))))))))))%^^^^%%%))--%%%^^^^^^^^^%-)))))))))%^rr
)-+-++-)-))))))))))))))))%^^^^^^^%)--%^^^^^^^^^^^%)))))))))))%rr
)-+----)-)))))))))))))))))%^^^^^^%----%%^^^^^^^^^^%)))))))))))rr
)---)))))))))))))))))))))))%^^^^^%-+----%^^^^^^^^^%))$))))))))rr
))))))))))%%%))))))))))))))%^^^^^%-++----%^^^^^^^^%)%^%%%)))))rr
))))))))))%^%))))))%%))))))%^^^^^%---+++-%^^^^^^^^%)%^^^^%))))rr
))))))))))%%^%)))))%%%)))))%%^^^^^%%-----%^^^^^^^%)))%^^^%))))rr
))))))))))))%%)))))))%%%%%)))%^^^^^^%%%%%^%%%^^^^%)))%^^^^%%))rr
))%%))))))))))))))-)--%^%)))))%^^^^^^^^^^%)))%^^^%)))%^^^^^^%)rr
)%^^%)))))))))))))----%^%))))))%^^^^^^^^%)))))%^%)))))%^^^^^^%rr
)%^^^%))))))))))))-++--%%))))))%^^^^^^^^%)))))%^%))))))%%%%^^^rr
)%%%%%))))))))))))---+-%%))))))%^^%%%^^^%)))))%^%))))))))))%%%rr
)))))))))))))))))))-+--%^%%%)))%%%)))%^^%)))))%%))))))))))))))rr
)))))))%%%%))))))))---)%^^^^%%))))))))%^%)))))%%))))))))))))))rr
))))))%^^^^%)))))))))))%^^^^^%)))))))))$)))))$^%))))))))))))))rr
))))))%^^^^^%))))))))))%^^^^%)))))))))))))))))%%))))))))))))))rr
))))))%^^^^^^%))))))))%^^^^^%)))))))))))))))))%^%)))))))))))))rr
))))))%^^^^^^^%))%%%)$%%^^^^^%))))%%%)))))))))%%^%%%))))))))))rr
))))))%^^^%%%^^%%^%)))--%%%%^^%))%^^%)))))))))))%%%^%%)))))))-rr
))))))%^^%)))%^^^%----------%^^%%^^^%))))))))))))))%^^%%))))--rr
))%%%%^^%)))))%^%--++-------)%^^^^^^^%)))))))))))))%^^^^%%%---rr
)%^^^^^^%)))))%^%-+--+--)))))%^^R^^^^%)))))))))))))%^^^^^^^%%-rr
)%^RR^^%)))))))$--+++++-))))))%^^^%%^^%)))))))))))%^^^^^^^^%%-rr
-%^^^^^^%)))))))--------))))))%%%%))%^^%%%%)))))))%^^^^^^^%)--rr
-%^^^^^^%)))))))))))-+-))))%%))))))))%^^^^^%%))))))%^^^^^%))--rr
-%^^^^^^^%))))))))))---)))%^^%%)))))))%^^^^^^%%)))))%%^^%)))-)rr
-%%%%^^^^^%%)))))))))))))%^^^^%)))))))%^^^^^^^^%%%%)))%%))))))rr
$%#)-%^^^^^^%%%%)))))))))%^^^^%)))))$)%^^^^^^^^^^^^%()))))))))rr
))))--%^^^^^^^^^%%%%))))))%^^^%))%%%^%^^^^%%%^^^^^^^())))))%%)rr
))-++--%%%%%%%%%%%%%))))))%^^%)))%^^^^^%%%)))%%^^^%%%--))))%%%rr
))--++--)))))))))))))))))))%%))))%%%%%%))))))))%%%)----)))))))rr
))-----))))))))))))))))))))))))))))))))))))))))))))-+-))))))))rr
rrrrrrrrrrrrrrrrrrrrrrrrrrrrrrrrrrrrrrrrrrrrrrrrrrrrrrrrrrrrrrrr
rrrrrrrrrrrrrrrrrrrrrrrrrrrrrrrrrrrrrrrrrrrrrrrrrrrrrrrrrrrrrrrr
