^^^^^^^%^^^^%))))))))))%^^^^^%)))%^^^%%%^^^^^%))-++--)%%))))))rr
^^^%%^^^^^^^%))))))))))%^^^^^^%)$^^^%)))%%^^^^%)----)-))))))))rr
^^%))%^^^^^^%))))))))))%^^^^^^%))%^^%)))))%%^^%))-$)))))))))))rr
%%))))%%^^^^%))))))))))%^^^^^^%)%^^^%)))))))%^^%%%%)))))))))))rr
))))))))%%^^^%)))))))))%^^^^^^^%^^^^%)))))))%^^^^^%)))))))))))rr
))))))))))%^^^%%)))))))%^^^^^^^^^^^^^%))))))%^^^^%))))))))))))rr
))))))))))%^^^^^%%%%))%^^^^^^^^^^^^^^%))))))%^^^^%))))))))))))rr
)))))))))%^^^^^^^^^^%%^^^^^^^^%%^^^^^%)))))))%^^%)))))))))))))rr
))))%%%%%^^^^%%%%%^^^^^^^^^^^%))%%^^^%)))))))%^%%)))))))))))))rr
))))%^^^^^^^%)))))%^^^^^^^^^%)))))%%%)))))))))$)))))))))))))))rr
)))))%^^RR^^%)))))%^^^^^^^^^%))))))))))))))%%)))))))))))))))))rr
)))))%^RrR^^%)-)))%^^^^^^^^^%))))))))))))))%^%))))))))))))))))rr
)))))%^RrR^^%)---)%^^^%%%%^^^%))))))))))))$%%^%)))))))))))))))rr
)))))%^^R^R^^%-+-)%^^%))))%%%^%))))))))))$)))%^%))))))))))))))rr
)))))%^^^RrR^%---)%^^%)))))))%^%))))))))))----%%))))))))))))))rr
)))))%^^^RrR^%)))%^^^%)))))))%^^%)))))))))-++-%^%)))))))))))))rr
)))))%^^RRR^^%)))%%%%%)))))))%^^%)))))))))--+-%^%)))))))))))))rr
)))))%^^^^^%%%)))))))))))))))%^^%))))))))-----%^^%%)))))))))))rr
))))))%^^^%))))))))))))))))))%^^^%)))))))---%%^^^^^%%)))))))))rr
-)))))%^^%)))))))))))))))))))%^^^%)))))))-%%^^^^^^^^%)))))))))rr
-)))))%^%))))))))))))))))))))%^^^%)))))))$^^^^^^^^^^^%))))))))rr
--))))%^%)))))))))))))))))))))%^%)))))))))%^^^^^^^%%%%))))))))rr
+-)))%^^%))))))%%)))))))))))))%^^%%%))))))%^^^^^^%))))))))))))rr
--)%%^^^%)))))$^^%))))%%))))))%^^^^%))))))%^^^^%%)))))))))))))rr
)))%%%%%)))))))%%))))%^^%)))))%^^^%%))))))%%%%%)))))))))))))))rr
))))))))))))))))))))%^^^%)))))%^^%))))))))))))))))))))%%%)))))rr
))))))))))))))))))))%^^%))))))%^%)))))))))))))))))))))%^^%))))rr
)))))))))))))))))))%^%%%))))))%%))))))))))))))))))))))%^^%))))rr
)))))))))))))))))))%%)))))))))))))))))))))))))))))))))%^^%))))rr
))))))))))))))))))%^%)))))))))))))))))))))))))))))))))%^%)))))rr
))))))%%%%%%))))))%^%)))))%%%))---))))))))))%%%%%%%%%%^^%)))))rr
)))))%^^^^^^%%)))%^^%)))))%^%))-+----))))))%^^^^^^^^^^^%))))))rr
))))%^^^^^^^^^%%%^%%)))))$%%%)--++++-))))))%%%%%%%%%%^^%))))))rr
)))%^^^^^^^^^^^^^%))))))))))))-+++++-))))))))))))))))%%))---))rr
))%^^^^^^^^^^^^^^%))))))))))))-++-+--))))))))))))))))))))-+-))rr
)%^^^^^^^^^^^^^^%)))))))))))))--+---)))))))))))))))))))---+--)rr
)%^^R^^^^^^^^%%%)))))))))))))))---)))))))))))))))))))))-+-+-))rr
)%^^RRR^^^^^%)))))))))%%%))))))))))))))))))))))))))))))--+---)rr
)%^^RrrRR^^^%)))))))))%^^%%)))))))))))))))))))))))))))))---)))rr
)%^^RRRRR^^^%)))))))))%^^^%)))))))))))))))))))))))))))))))%%%)rr
)%^^^^^^^^^^%)))))))))%%%%))))))))))))))))))))))))-----))%^^%)rr
))%^^^^%%%%%%)))))))))))))))))))))))))))))))))))))-+----%^^^%)rr
))%^^^%-------))))))))))))))))))))))))))))))))))))---%%%^^^^%)rr
))%^^%--++-++-))))))))))))))))))))))))))))))))))))-%%^^^^^^^^%rr
))%%%)--------)))))))))))))))))))))))))))))))))))%%^^%%%%%^^^%rr
)))))))))-)))))))))))))))))))))$))))))))))))%%%%%^^^%)))))%^^%rr
))))))))))%%%)))))))))))))))%%%^%)))))))%%%%^^^^^R^^%)))))%^%)rr
)----))))%^^%))))))))))))))%^^^^%%%)))))%^^^RRRRRR^^^%))))%^%)rr
--++---)%^^%%))))))))))))))%^%%%))))))))%^^RrrrrrR^^^%))))%%))rr
-+-+-+-%^^%))))))))))))))))$)))))))))))))%^^RRrrR^%%%%))))))))rr
---+++-%^%)))))))))))))))))))))))))))))))%^^^^RR^%))))))))))))rr
))-+++-%%)))))))))))))))))))))))))))))))))%^^^^^%))))))%%)))))rr
))--+--%)))))))))))))))))))))))))))))))))%^^^%%%))))))%^%)))))rr
)))---)$))))))))))))))))))))))))))))))))%^^^()))))))))%^^%))))rr
)))))))))))))))))))))))))))))))$)))))))%^^^^()))))))))%^^%))))rr
))%%%%)))))))))))))))))))))))))$)))))))%^^^^%)))))))))%^%)))))rr
))%^%))))))))))))))))))))))))))))))))))%%%^^^%))))))))%%%---))rr
))%^%)))))))))))))))))))))))))))))))))))))%^^^%))))))))))-))-)rr
))%^%))))))))))))))))))))))))))))))))))--)%^^^^%)))))))---))--rr
))%%))))---))))))))))))))))))))))))))))----%%%%%)))))))-+++++-rr
)))))))--+--)))))))))))))))))))))))))----+--)))))))))))---+++-rr
)))))))-+-+-)))))))))))))))))))))))))--++-+-)))))))))))))-++--rr
rrrrrrrrrrrrrrrrrrrrrrrrrrrrrrrrrrrrrrrrrrrrrrrrrrrrrrrrrrrrrrrr
rrrrrrrrrrrrrrrrrrrrrrrrrrrrrrrrrrrrrrrrrrrrrrrrrrrrrrrrrrrrrrrr
