))^&&&^)^&^^^&&^&&&&&&&&&^----^&))&&&^))))))+^&&)&^^+++)))))))))
)^&&&&&^&^)))^&&&&^^^&&)&^--+-^&&&&&&&^)))))))^)&^+++++)))))))))
^&&)&&&&^)))))^&)^)))^&&&&^-+-^&&&&&&&&^^)++)+^&^+++++++++^^^^))
^&)&&&&^))))))^))^))))^^^^^^-+-^^&&&&&&&^))+++^&^+++++)++^&&&&))
^&&&&&^)))))))^&)^)))))))))^)))))^&^&&&&^))++++%++++++)+^&&^&&))
^&))&^))))))))^&&^)))))))))^))-----^&&^^^^))+++++++++++^^&&^&&&))
^&&&^))))))))^&&&&^))))))))^^--++-^&&&&&^))+++++++++^^&&&^&&^&))
^&&&^)))))))^&^&^^^^))))))^&^-++--^&&&&&^))))))+^^^^&^&^&&&&&&))
&&&^)))))))^&^)%))))))))))^&&^---^&&&&&&^++++))^&&&&&&&&&&^^&&))
&&&^))))))^&^)))))))))))))^&&&^^^&^^^&&&^+++)))^&&&&&^^^^^))^&))
&^^)))))))^&^)))))))))))))^&&&&&&^)))^&&^+++))^&&&&&^))))))))^))
^)))))))))^&^)))))))))))))^&&&&&^)))))^&^+++))^&&&&&&^))))))))))
)))))))))^&&^))))))))))))))^&&&&^))))))%))))))^&&&^^&&^)))))))))
))))))))^&&&^))))))))))-))))^&&&&^))))))))))))^&&^))^&&^^^^)))))
)))^^^^^&&^^))))))))))-))))-)^&&&&^^))))))))^^&&^))))^&&&&&^^)))
))^&&&&&&^)))))))))%)))-)--)))^^&&&&^))))))^&&&&^))))^&&)&&&&^))
++^&&&&&^))))))))))^^)))---)))))^^&&&^))))^&&^^^))))))^&&&&^^^))
+++^&&&&&^))))))))^&&^))))))))))))^&&&^))^&&^))))))))))^^^^)))))
+++^&&&&&&^^))))))^&&^)))))))----)^&&&&^^&&^))))))))))))))))--))
+++^&&&&&&&&^)))))^&&^)))))+)----))^&&&&&&&&^))))))))))))--+--))
++)^&&&&&&&&^)))))^&&^)))))))--+-))^&&&&&&&&&^)))))))))))-+++-))
))^&&&&&&&&&&^)))^&&^))))))))-++-)))^&&&&&&&&&^^)))))))))--++-))
))^&&&^r^^^&&&^^^&&&^))))))))--+-))))^&&&&&&&&&&^^)))))%)-----))
))^&&&^rr^^&&&&&&&&&^)))))))))-+-)))))^&&&&&&&&&&^))))%^)))))-))
))^&&&&^^&&&&&^^^^^&^))))))))))-++--)))^&&&&&&&&^^^^^)))))))))))
))^&&&&&&&&&&^)))))^^)))))))----++--)))^^&&&&&^^))^&^)))))))))))
))^&&&&&&&&&^))))))^^)))))))-----+--)))))^&&&^)))^&&&^)))))%))))
))^^^^^^^&&&^)))))))))))))))--%^-++-)))))^&&&^)))^&&&^))))^&^)))
)))))))))^^^&^))))^^))))))))))+)-++-))))))^&&^)))^&&&^))))^&^)))
))))))))))++^&^))^&^))))))))))))-++-))))))^&&^+++^^^^)))))^&&^))
))))))))+++++^&^^&&^)))))))))))))-+---))))^&&^+++++)))))))^&&^))
))))))))++++++^&&&&^)))))))^^)))------))))^&&^++++++)))))^&&&&))
)))))+++++++++^&&&&^))))))^&&^))-------))^&&^^++++++)))))^&&&&))
)))))++++++++^&&&&&^))))))^&&&^)-------)^&^^)))+++++))))^&&^^&))
))))))+++++++^&&&&^)))))))^&&&&^^--++-^^&^))))))++++)))^&^^))^))
)))))))))++++^&&&^)))+))))^&&&&&^-++-)^&^))))))+++)^^^^^^)))))))
))))))))))++++^^^)))))))))^&&&&&^-++-)^^)))))))+++%&^^^)))))))))
))))))))))+++++))))))))))%&&^^^^-+---))))))))))++++%+++++)))))))
))^^^)))))++++++))))))))))^^-------))+)))))))))++++++++++)))))))
))^&^)))))+%++++)))))))))-------))))+++)))^^)))++++++++++))%))))
)%&&&^)))))^^+++)))))))))-------))))++++)^^^)))++++++++++)))))))
))^^^))))))))%)))))))))))--%----))))++++%^)))))++++++++++)))))))
))))))))))))))))))%)))))))^&^--)))))++++))))))))))))++++++))+)))
)))))))))))))))))%^)))))))^&^)))))))+++)))))))))))))))++++++++))
))))))))))))))))))))))))))^&&^))))))+++%)))))))))^^))))+++++++))
)))))))))))++++)))))))))))^&^&^^))))))^&^))))))^^&&^))))))++++))
))))))))))++++++))))))))))^^r^&&^^)))^&&&^)))^^&&&^)))))))))++))
)))))))))++++++++))))))))^&^^^^&&^)))^&&&^))^&&&&&^)))))))))))))
)))))))))++++++++))))))))^&^^&&^^)))))^&&&^^&&&&&^))))))))))))))
)))))+)+)++++++++))^^^)^^&^&&^^))))))))^^&&&&&&&&^)))++++)))))))
))))++++)))+++)))^^&&&^&&&&&^))))))))))))^&&&&&&^)))++++++))))))
))+++++++++)))))%&&&&&&&&&&&^))))))))))))^&&&&&&^)))+++++)))))))
))++++++++++)))))^^^&&&&&&&^))))))))))))^&&&&&&^))))+++)))))))))
))++++++))++)))))+++^&&&&&&&^++))))))))^&&&&&&&&^)))))))))))))))
))++++++))))+))++++++^&&&&&&^+++))))))^&&&&&&&&&&^)%))))))))))))
))^^+++))))%)))++++++^&&&&&&^+++)))^^^^^&&&&&&&&&&^&^^^^))))))))
)^&^)))))))^^))++++++^&&&&&&^+++))^&^)))^^&&&&&&&&^^^&&^))))))))
^&^^^)))+++^&^)++++++^&&&&&&&^++))^^))))))^&&&&&&^))))&)))))))))
^&^^^+)++++^&&^^)++++^&^^&&&&^)))))))))))))^&&&&^)))))^)))))))))
^^^^++)++++)^^^^)++++^&&&&&^^^))))))))))))))^^^^+++))))^^)))))))
++++++)++++++))))))+++^^^^^))))))))))))))))))))++++)))))))))))))
++++++)++++++)))))))++++))))))))))++++)))))))))+++++))))))))))))
))))))))))))))))))))))))))))))))))))))))))))))))))))))))))))))))
))))))))))))))))))))))))))))))))))))))))))))))))))))))))))))))))
