))))))))))))))))))))))%^^^^^^(^^^^%)))))%(^^^((^^^^^^^^(%)))))rr
)))))))))))))))))))))%^^^^^^^^^^^^%)%%%%^^^%%^^^^^^^^^^^^%))))rr
))(%)))))))))))))))%%^^^^^^^^^^^^%))%^^((^%))%^^^^^^^^^^(^%%%)rr
)%^^%)))))))))))))%^^^^^^^^^^^^^^%)))%^^^%-)))%^^^^%%^^^^^^^^%rr
%^^^%)))))))))))))((^%%%%^^^^^^^^%)))%^^%))-))%^^^%))%%%%%^(^^rr
^^^^%)))))))))))))((%))))%^^^^^^^^%%%)%%)---))%^^%))))))))%^^^rr
^^%%)))))))$))))))%^%)))))%^^^^^^^^^^%)))-+-))%^^%))))))))%^(^rr
%%))))))))%(%)))))^^%)))))%^^^^^^^^^^%)))---)%^^%)))))))))%^^^rr
))))))))))%%^%)))%^^%))))))%%^^^^^^^^^%))))))%^^%)))))))))%^^^rr
))))))))))))%^%%%^^^%)))))-)-%^^^^%%%^^%))%%%^^^^%)))))))%^^^^rr
)))))))))))))%%^^^^^^%)))))---%^^%)))%%^%%^^^^^^^%)))))))%^^^^rr
)))))))))))))))%^^^^^%)))---+-%^%))))))%^^^^^RR^^%)))))))%^^^^rr
))))))))))))))))%%%%%%)))-+++--%%)))))))%^^^^^R^^%)))))))%^^^^rr
)))))))))))))))))))))%%))--++--%%))))))))%%%^^^^^^%%)))))%^^^^rr
%%%%%%%%%%))))))))))))%%))----%%)))))))))---%^^^^^^^%%))%^^^^^rr
^^^^^^^^^^%%)))))))))))%%)))--$))))))))))---)%^^^^^^^^%%^^^^^^rr
^^^^^^^^^^^^%))))))))))%^%%)))))))))))))))))-%^^^^^^^^^^^^^^^^rr
^^%%%^^^^^^^%))))))))))%^^^%)))))))))))%%%%%%^^^^^%%%^^^^^^^^^rr
^%)))%^^^^^^^%))))%%%%%^^^^^%)))))))%%%^^^^^^^^^^%)))%^^^^^^^^rr
%)))))%^^^RR^%))))%^^^%%%^^^%))))))%^^^^^^RR^^^^%)))))%^^^^^^^rr
%))))))%%^^^^%)))$^^^%)))%%%%))))))%%%%%^^^^^^%%)))))))%^^^^^^rr
%))))))))%^^^%))))%^%)))))))))))))))))))%%%%%%))))))))))%^^^^^rr
^%%%))))))%^%)))))%^%))))))))))))))))))))))))))))))))))))%^^^^rr
^^^%))))))%^%)))))%^%))))))))))))))))))))))))))))))%%))))%^^^^rr
%%^^%))))))%^%)))%^^%)))))))))))))))))))))))))))))%^^%%)%^^^^^rr
))%^%)))))))%^%%%^^^^%)))))))))))))))))))))))))))%^^^^^%^^^%%%rr
))%^%))))))))%^^^^^^^^%)))))))))))))))))))))))))%^^^^^^^^%%)))rr
)%^^%))))))))%^^^^^^^^%))))))))))))))))))))))))$%^^^^^%%%)))))rr
)%^^%)))))))))%^^^^^^%)))))))))))))))))))))))))))%^^^%))))))))rr
%^^^^%))))))))%^^^^^%)))))))))))))))))))))))))))))%^%)))))))))rr
^^^^^^%%))))))%^^^^^%)))))))))))))))))))))))))))))%%))))))))%%rr
^^^^^^^^%))))))%^^^^%)))))))))))))))))))))))))))))%^%)))))))%^rr
%%^^^^^^%)))))))%%^^^%))))))))))))))))))))))))))))%^%))))))))%rr
))%^^^^^%)))))))))%^^^%%))))))))))))))))))))))))))%^^%))))))))rr
))%^^^^^%)))))))))%^^^^^%%))))))))))))))))))))))))%^^^%%%)))))rr
))%^^^^^%))))))))))%^^^^^^%)))))))))))))))))))))))%^^^^^%)))))rr
)%^^^^^^%))))))))))%%^^^^^^%)))))))))-))))))))))))%^^^^^%)))))rr
)%^^^^^^%))))))))))))%%^^^^%)))))))))))))))))))))))%^^^^%))--)rr
)%^^^^^^%))))))))))))))%^^^^%)))))))-----))))))))))%^^^%))-)--rr
)%^^^^^%%))))))))))))))%^^^^%)))))))-+-+--)$))))))))%^^%))---+rr
%^^^^%%))))))))))))))))%^^^^^%)))))--++-+-))$))))))))%^%)--++-rr
^^^^%))))))))%%%%%))))%^^^^^^^%%%%%----+--)))$)))))))%^%))-+--rr
^^^^%))))))))%^^^%)))$^^^^^^^^^^^^^%-----)))))$%%)))))%^%)---)rr
^^^^%)))))))))%^^%))))%^^^^^^^^^^^^%)))))))))))$))))))%^%)))))rr
%%%%))))))))))%%%)))))%^^^^^^^^^^^^^%)))))))))))))))))%^%)))))rr
))))))))))))))))))))))%^^^^^^^^^^^^^%)))))))))))))))))%^%)))))rr
))))))))))))))))))))))%^^^^^^^^^^^^^%))))))))))))))))))%%)))))rr
))))))))))%%%)))))))))%^^^^^^^^^^^^^%))))))))))))))))))%^%))))rr
)))))))))%^%%%))))))))%^^^^^%%%%%%^^%)))))%%)))))))))))%^^%)))rr
))))))))%^%))$))))))))%^^^^%))))))%^^%)))%^%)))))))))))%^^^%%%rr
)))))))%^%))))%%))))))%^^^^%)))))))%^^%%%^^^%))))))))))%^^^^^^rr
))))))$^%)))))%^%%%%%%^^^%%)))))))$^^^^^^^^^%)))))))))$^^^%%%^rr
)))))))$)))))))%^^^^^%%%%))))))))))%%^^^^^^%%))))))))))%^%)))%rr
))))))))))))))%^^^^^%))))))))$)))$)))%^^^^%))$)))))))))%%)))))rr
))))))))))))))%^^^^^^%)))))))%%%%)))))%^^%))))$))))))))$))))))rr
))))))))))))$%^^^^^^^%)))))))%^^%)-))))%%)))))%%%)))))))))))))rr
)$)%%%%%%%)))%^^^^^^^%))))))%^^^%----)))))))))%^%)))))%%))))))rr
%^%^^^^^^%)))%^^^^%%%^%)))%%^^^^%--+--))))))))%^^%%%%%^%))))))rr
^^%^^^^^^%))))%^^%---%%%%%^^^^^^^%--+-))))))))%^^^^^^^^^%)))))rr
%%)%%%^^%))))))%%--+---)%^^^^^^^%-----)))))))))%%%%%%%%%))----rr
))))))%%))))))))--++++-))%%%%%%%%)--)))))))))))))))))))))--++-rr
)))))))))))))))))-+++--))))))))))))))))))))))))))))))))))-+++-rr
rrrrrrrrrrrrrrrrrrrrrrrrrrrrrrrrrrrrrrrrrrrrrrrrrrrrrrrrrrrrrrrr
rrrrrrrrrrrrrrrrrrrrrrrrrrrrrrrrrrrrrrrrrrrrrrrrrrrrrrrrrrrrrrrr
