^^(%(^^(^(^(%)))---++--++++---))))))))))%^^(^(^(%))%%))))%^^^^rr
^((^^^^^^^^^%))))-----------)))))))))))%^^(%%%%-)))%^%%%%^^^^^rr
^((^^^^^^^^^%))))))%%%%%----)))))))))%%(^%----)))))%^^^^^^^^(^rr
^^^^^^^^RR^^^%))))%^^^^^%%%%%%%))%%)$%(^%)-----)))))%^^^^(^^(^rr
^^%%^^^^^^^^^%)))))(^^^^^^^^^^^%%^^%))%%))))))-))))))%%^(^(^^^rr
^%))%^^^^^^^%%---)))%^^^^^^^^^^^^^^%))))-))))))))----))%%^^^^(rr
%))))%%^^^%%---+-))-)%^^^^^RRRRR^^^%-))))))))))))-++---))%^^^^rr
%))))))%%%)--++--))---%^^^^RRRRR^^%----))))%%))))----+--)%^^^^rr
)))))))))))------))-+-%^^^^^^^^^%%^%---)))%^^%%)))--++--)%^^^^rr
%))))))))))%%%%%-)----%^^^^^^%%%^^%^%--)))%^^^^%%%%-+---%%%%%^rr
^%%%%)))))%^^^^^%))))-%^^^^^%^^)))%^%)))))%^^^^^^%--+-$%%)---%rr
^^^^%)))))%^^^^^%)))))%^^^^^%^^^^^%^^%)))%^^^^RR^%-+---$))-+--rr
^^^^^%)))%^^^^^^%)))-)%^^^%%^%^^^%^^^^%))%^^^^^^^%---)))))-++-rr
^^%%^^%%%^RRR^^^%)))))%^^%))%^%%%^%%%^^%%^%%%%^^%---))))))----rr
^%))%%^^^^RrR^^(%)))))%^%))))%^^^%)))%^^^%))))%%--+-)))))%%%%%rr
%)))))%^^^RRR^^^%)---%^^%)))))%^^%))))%^^%)))))-----)))))%^^^^rr
)))))))%%^^^^^^^%--+-%^^%)))))%^%)))))%^%))))))---)))))))%^^R^rr
)))))))))%%%%^^^%-++-%^^%)))))%^%--))--%%))))))))-))))))))%^^^rr
)))))))))))))%%%--++--%^%)))))%^%))))--%^%%%%))))))))))))))%%%rr
)))))))))))))))$--+---%%%)))))%^%)-))---%^^^%)))))))))))))))))rr
)))))))))))))))))---))))))))))%%%)))))---%^^%)))))))))))))))))rr
))))))%%%)))))))))))))))))))))))))))))-+--%^%----))))))))))))-rr
)))))%^^^%))))))))))))))))))))))))%%))----%^%-++-))%%)))))))--rr
)))))%^^^%)))))))))))))))))%%%%%%%^^%))-)-%^%-+--)%^^%)))))--+rr
)))))%^^%))))))))))))))))))%^^^^^^^^%)))))%^%---)%^%%%)))))-++rr
%%))))%^%)))))))))))))))))))%^^^^^%%)))))%^^^%-))%%))))))))---rr
%----)%^%)))))))---))))))))))%^^^%)))))))%^^^%)))))))))))))))-rr
%--+-)%^%)))))))-+---)))))))))%^^%))))))$^^^^^%))))))))))))))$rr
--++--%^%)))))))-+++--))))))))%^%))))))))%^^^^^%))))))))))))))rr
-+++--%^%)))))))-+-++-)))))))))$))))))))))%^^^^%))))))))))))))rr
-++-+-%^^%%)))))-++---))))))))))))))))))))%^^^^^%)----))))))))rr
--++--%^^^^%)))))---)))))))--))))))))))))-%^^^^^%)-++-))))))))rr
)-+++-%^^^^^%))))))))))))--+--)))))))))))%^^^^^^%)-++--)))))))rr
)--+--%^^^%%))))))))))))--+++-))))))))%%%^^^^^^^%)---+-)))))))rr
))----%^^%))))))))))))))-++---)))))--$^^^^^^^^^^%)))---%%%%)))rr
-)-+--%^^%))))))))))))))-+++-)))))----%^R^^^^^^^%)))-))%%^^%%)rr
))-++-%^%)))))))))))))))-+++--))))-++-%^^^^^^^^^%))))))))%^^^%rr
))-+--%^^%))))))))))))))--+---)))--++-%^^^^^^^^^^%))))))))%^^^rr
)--+--%^^^%%)))))))))))))---+--%%-+++-%^^^^^^^RR^^%%))))))%^^^rr
))---))%^^^^%))))%%%%)))----++-%%---+--%%%^^^^RrR^^%))))))%RR^rr
))))))))%%%^^%%%%^^%%)))-+-+++-))))---))))%^^^^R^^^%))))))%^^^rr
)))))))))))%^^^^^^%)))---+++++-))))))-))))%^^^^^^^^%))))))%^^^rr
-)%%)))))))%^^^^^%))))-++----+-)))))--)))))%^^^^^^^%))))))%^^^rr
-%^^%))))))%^^^^%)))))-+---$---)))%%%---))%^^^^^^^^^%)))))%^^^rr
$^^^^%))))%^^^^%))))))---%%^%%)))%^^%----)%^^^^^^^^^^%))))%^^^rr
-%%%%%)--%^^^^^%))))))--%^^^^^%%%^^^^%--)%^^^^^^^^^^^^%%%%^^^%rr
---------%^^^^%))))))))%^^^^^^^^^^^^^^%%%^^^^^^^^^^^^^^^^^^^^%rr
+--+-+--%^^R^^%))))))%%^^^^(^^^RR^^^^^^^^^^^^^^^^^^^^^^^^^^^^%rr
-++++---%^^RR^%))))))%^^^^^^^^^RrR^^^^^^^^^^^^%%%%^^^^^^^^^^^%rr
-++++-))%^^^^^^%)))))%^^^^^^^^^RrR^^^^^^^^^^^%))))%^^^^^^^^^^%rr
----+-)))%^^^^^%))))))%^^^^^^^RrR^^^^^^^^^^^%)))))%^^^^^^^^^^%rr
)-)---)))%^^^^%)))))))%^^^^RRRRR^^^^^^^^^^^^%))))))%%%%%%%^^%)rr
)))))))))%^^^^%))))))))%^^^^^^^^^%%^^^^^^^^^%)))))))))))))%^%)rr
))))---))%^^^%))))))))))%^^^^%%%%))%^^^^^^^%))---))))))))))%%)rr
))))-----%^^^%)))))$)))))%^^%)))))))%^^^^^^%)--+-))))))---)%%)rr
))%%%---)%^^^%)))%%^%%)))%^^%))))))))%%^^^^%--++--)))))-+-))))rr
))%^^%---%^^^%))%^^^^^%))%^%)---)))))))%%%^^%---+-))))--+--)))rr
))%^%---))%^^^%%^^%%%^^%%^%-----))))))))))%^^%----)))--+-+--))rr
))%^%---))%^^^^^%%)))%^^^%--++-$))))))))))%^^^%--)))--+++++-))rr
))%%%))))-%%%%%%)))))-%%%---+--)))))))))))%%%%%)))))-+--+---))rr
)))))))))---))))))------))-----)))))))))))))))))))))--++--))))rr
))))))))--+-))))))-++-+-)))))))))))))))))))))))))))))-+--)))))rr
rrrrrrrrrrrrrrrrrrrrrrrrrrrrrrrrrrrrrrrrrrrrrrrrrrrrrrrrrrrrrrrr
rrrrrrrrrrrrrrrrrrrrrrrrrrrrrrrrrrrrrrrrrrrrrrrrrrrrrrrrrrrrrrrr
