)))%^^%)))))))))))))))))))))))))))))))))))))))))))%%))))))))))rr
)))%^^^%)))))))))))$))))))))))))))))))))))))))))%(^%))))))))))rr
-))%^^^^%))))))))%%^%)))))))))))))))))))))))))%%^((%))))))))))rr
-))%^^^^^%%%%))))%^^^%))))%%))))))))))))))))))%^(^^%)))))))$))rr
--)%^^^^^^^(^%))$^^^%)))))%^%))))))))))))))))))%%%^%)))))))%%)rr
-)%^^^%%(^^^^%)))%%%))))))%(%)))))))))))))))))))))%%))))))))))rr
)%^^^%))%^^^^%))))))))))))%(%)))))))))))))))))))))%^%)))))))))rr
)%^%%%)))%^^^^%)))))))))))%(%))))))))))))))))))))%^^%)))))))))rr
)%%))))))%%^^^^%))))))))))%^%)))))))))))))))))))%^^^^%))))))))rr
%%)))))))))%^^^^%%)))))))%^^(%))))))))))))))))%%^^^^^^%%)$))))rr
%))))))))))%^^^^^^%%%%)%%^^^^^%)))))))))))))))%^^^%%^^^^%%))))rr
))))))))))))%^^R^^^^^^%^^^^^^^%)))))))))))))))%^^%))%^^^^%))))rr
))))))))))))%^^^^^%%%%%%%^^^^^%))))))))))))))))%%))))%^^^%))))rr
))))))))))%%^^^^^%)))))))%^^^%))))))))))))))))))))))))%^^^%%))rr
)))))))%%%^^^^^%%))))))))%^^%)))))))))))))))))))))))))%^^^^^%%rr
))))))%^^^^^^%%))))))))))%^^%))))))))))))))))))))))))))%^^^^^^rr
))))))%^^^^^%))))))))))))%^^%)))))))))))))))))))))))))))%%^^^^rr
)))))%^^^^^^%))))))))))))%^^%)))))))))))))))))))))))))))))%^^^rr
%))%%^^^^^^^%)))))))))))%^^^%)))))))))))))%%))))))))))))))%^^^rr
^%%^^^^^^^^^%))))))%%%))%^^^%))))))))))))$^^%%))))%%))))))%^^^rr
^^%%%^^^^^^^%)))))%^^^%%^^^^^%))))))))))))%^^^%%%%^^%)))))%^^^rr
%%)))%^^^^^^^%)))%^^^^^^^^^^^^%))))))))))))%^^^^^^^^^%)))$%%%%rr
))))))%^^^^^^^%)%^^^^^^^^^^^^^^%%))))))))))%^^^^^^^^^^%)))))))rr
)))))))%%%^^^%)$%^^RRR^^^^^^^^^^%))))))))))%^^^^^^^^^^^%))))))rr
))))))))))%^%))))%^^RrR^^^^%%^^^%))))))))))%^^^^^^^^^^^%))))))rr
)))))))))))%))))))%^^RR^^^%))%^^%))))))))))%^%%%^^^^^^^^%)))))rr
)))))))))))%))))))%^^^R^^%))))%^^%%%%)))))%^%)))%^^^^^^^%)))))rr
))))))))))%^%)))))%^^^^^^%)))))%^^^^^%))))%^^%))%^^^^^%%))))))rr
))))))))))%^%)))))%^^^^^%))))))%^^^^^%))))%^^%)%^^^^^%))))))))rr
)))))))))%^^^%)))%^^^^^^%)))))%^^^^%%)))))%^^^%^^^^^%)))))))))rr
))))$)))%^^^^^%%%^^^^^^^^%)))%^^^^%)))))))%^^^^^^^^^%))))))$))rr
)))$^%%%^^^^^^^^^^^^^^^^^%))%^^^^%)))))))%^RR^^^^^^^%)))))%^%)rr
))))%^^^^^^^^^^^^^^^%^^^^^%%^^^^^%))))))%^^^^^^^^^^^^%)))%^^%)rr
)))))%^^^^^^^^^^^^^%)%^^^^^^^^^^^%)))))%^^^%^^^^^^^^^^%%%^^%))rr
))))))%^^^^^^^^^^^%-))%^^^^^^^^^%)))))%^^^%)%^^^^^^^^^^^^^%)))rr
)))))))%^^^^^RR^^^%)-)%^^^^^^^^^%)))))%^^%)))%^^^^^^^^^^^%))))rr
))))))))%%%^^^R^^^%)))%^^^^^^^^^%)))))%^^%))))%^^^^^^^^^^%))))rr
)))))))))))%%^^^^^^%%%^^^^^^^^^^%)))%%^^^%)))))%^^^^^RR^^%))))rr
%%%%)))))))))%^^^^^^^^^^^^^^^^^^^%%%^^RR^%)))))%^^^^^RrR^%))))rr
^^^^%)))))))))%^^^^^^^^^^^^^%%%%^^^^RRrR^%))))))%^^^^RrR^%))))rr
^^^^^%)))))))))%^^^RR^^^^^^%))))%^^^RrrR%))))))%^^^^^RrR^%))))rr
^^%%%^%%%))))))%^^^^^^^^^^^%)))))%^^RrrR%)))))%^^^^^^RrR^^%))%rr
^%)))%^^^%))))%^^^^^^^^^^^^%))))))%^^RrR^%)))$^^^^^^^RrR^^^%%^rr
%)))))%^^%))))%^^^^^^^^^^^^%))))))%^^^R^^%))))%^^^^^^^RR^^^^^^rr
))))))%%%)))))%^^^^%%^^^^^%)))))))%^^^^^%)))))%%%%%%%^^^^^^%%^rr
)))))))))))))))%^%%))%%^%%))))))))-%%%^^%))))))))))))%%^^%%))%rr
)))))))))))))))%%))))))$))))))))))----%%)))))))))))))))%%)))))rr
))))))))))))))))))))))))))))))))))------))))))))))))))))))))))rr
)))))))))))))))))))))))))))))))))))))---))))))))))))))))))))))rr
))))))))))))))))))))))))))))))))))))))))))))))))))))))))))))))rr
))))))))))))))))))))))))))))))))))))))))))))))))))%%%%))))))))rr
)))))))))))))))))))))))))))-)))))%%))))))))))))))%^^^^%)))%%))rr
)))))))))))))))))))))))))))))))%%^%-----))))))))%^^^^^%)))%%))rr
)))))))))))))))))))))%%%%%%%%%%^^^%---+-))))))))%^^%%%))))))))rr
)))))))))))))))))))))%^^^^^^^^^^^^%-++--)))%%%)$%%%)))))))))))rr
)))))))))))))))))))))%^RRrrRRR^^^^%----))))%^^%)))))))))))))))rr
))))))))))))))))))))%^^RrrrrrrR^^^%))))))))%%%---)))))))))))))rr
))))))))))))))))))))%^^RRrrRRR^^^%)))))))))$---+-)))))))))))))rr
)))))))))))))))))))%^^^^^^^^^^^^^%))))))))))-++--)))((%(()))))rr
)))))))))))))))))))%%^^^^^%%%^^^%--)))))))))-+--))))%%%%%)))))rr
)))))))))))))))))))))%%%%%)))%%%---)))))))))---)))))))))))))))rr
))))))))))))))))))))))))))))))---+-)))))))))))))))))))))))))))rr
rrrrrrrrrrrrrrrrrrrrrrrrrrrrrrrrrrrrrrrrrrrrrrrrrrrrrrrrrrrrrrrr
rrrrrrrrrrrrrrrrrrrrrrrrrrrrrrrrrrrrrrrrrrrrrrrrrrrrrrrrrrrrrrrr
