)))%^^^^^^^^^^%%)))))))))))-++-)-)))))))))))))))))))%^^^%))---rr
))))%^^^^^^^^%))))%%))))))--+--))))))))))))))))))))))%^^%))--)rr
)))))%^^^^^^^%))))%^%)))))-+-+-))%%%))))%%%)))))-----)%^%)-))-rr
))))))%%^^^^%)))))%(%)))))--++-%%^^^%%%%%%%))))--+++--)%^%%)))rr
))))))))%%^^%)))))%^%)))))-++--%^^^^^%%%))%%%))-+---+-%^^^%)))rr
))))))))))%^%)))))%^^%))))-----%^^^^%)))))%^^%--+++++-%^^^%)))rr
))))))))))%^%))))))%%))))))))---%^^^%)))))%^^^%--+++--%^^^%)))rr
))))))))))%^%))))))))))))))))---%^^^%)))))%^^^^%-+---)%^^%)))-rr
)))))))))))%))))))))))))))))))))%^^^^%)))%^^^^^%------%%%))---rr
----))))))%^%))))))))))))))))))))%%%%^%%%^^^^^^%)))-+---)))-++rr
--+-))))))%^%))))))))))))))))))))))))%^^^^^^^^^%)))--++-)))---rr
----))))))%%)))))))))))))))))))))))))%^^^^^^^^^%)))-+++--))))-rr
--%%)))))%%%))))))))))))))))))))))))))%^^^^^^^^%)))--+---)%%%)rr
%%^%%%%%%%))))))))))))))))%%)))))))))))%^^^^^^^%))))---%%%^^^%rr
%^%-%^^^^%))))))))))))))%%^^%%))))---)))%^^^^^^^%))))%%^^^^^^^rr
%%---%%%%))))))))))))))$^^^^^%))))-+--))%^^^^%%%%))))%^^^^^^^^rr
))-----)))))))))))))))))%%^^^%))))--+-)))%^%%))))))))%^^^^^^^^rr
---+++-)))))))))))))))))))%%%%))))--+-))))$)))))))))))%^^^^^^%rr
++-----)))-)))))))))))))))))))-)))-+--)))))))))))))))))%^^^^%)rr
+--%%-)))-))))))))))))))))))-)))))---))))))-----))))))))%^^^%)rr
--%^^%))))))))))))))))))))))-))))%%%)$)))))-+-+--))))))))%%%%)rr
-%^^^^%%)-))))))))))))))))))))%%%^%))%%%%%%--+-+-)))))))))))))rr
)%^^^^^^%)))))))))))))))))))-%^^^%))))%^^^^%--++--))$)))))))))rr
)%^^^^^^%))))))))))))))))))))%^^^%)))))%%^^^%--+-))%^%))))))))rr
%^^^^%%%%)))))))))))))))))))))%%%))))))))%%^%----))%%^%)))))))rr
^^^^%))))))))))))))))))--)))))))-))))))))))%^%)-)$)))%^%))))))rr
^^^^%)))))))))))))))))))))%%%)))---))))))))%^^%%%)))))%^%%%%%%rr
^^^^%)))))))))))))))))))))%^%)))-+-))))))))%^^^%))))))%^^^^^^^rr
^^^^^%))))-))))))))))))-)%^^^%))-+--)))))%%^%%%)))-)))%^^^^^^^rr
^%%%%%))))))-))))))))))))%^^^%))---))%%%%^^%))))))))))%^^^^^^^rr
%))))%%))))))))$)))))))))%^^%))))-))%^^^^^^%))))))))))%^^^^^^^rr
)))))))))))))))%%)-))))))%^^^%))))))%^^^^^^^%))))-))))%^^^^^^^rr
)))))))))))))))))---)))))%^^^%)))))))%%%%%%%^%))))))))%^^^^^^^rr
)))))))))))))))))-+--))))%^^^^%%%%))))))))))%^%)))))))%^^^^^^^rr
))%%%)))))))))-))-++-))))%^^^^^^%))))))))))))%^%))))))%^^^^^^%rr
)%^^^%)))))))))))----))))%^^^^^^%))))))))))))%^%))))))%^^^^^^%rr
%^RR^^%)))))))))))))))))%^^^^R^^%)))))))))))))%%)))))))%%^^^^^rr
^R^^^^^%)))))))))))%%%%%^^^^^^R^^%))))))))))))%%)))))))))%^^^^rr
^^^%%^^^%)))))))))%^^^^^^^^%^^R^^^%%)))$))))))))))))))))))%^^^rr
^^%))%%%%)))))))))%^^^^^^^%)%^^^^^^^%%%%))))))))))))))))))%^^^rr
^%))))))))))))))))%^^^^^^%)))%^^^^^^^^^%))))))))))))))))))%^^^rr
^%)))-))))))))))))%^^^^^^%)))%^^^^^^^^^%)))))))))))))))))--%%^rr
%))))))))))))))))))%%^^^^%))))%^^^^%^^^%)))))))))))))))))----%rr
%))))))))))%%))))))))%^^%)))))%^^^%-%%%%)))))))))))))))))--+-)rr
))))))))))%^^%))))-)-)%%))))))%^^^%)----))))))))))))))))))---)rr
)----))))%^^^^%%%%%%))))))))))%^^^^%-+--)))))))))))))))))-----rr
))-+--)%%^^^^^^^^^^%))))))))))%^^^^%--+-)))))))))))))))))))-++rr
))---%%^^^^^^^^^^^^^%)))))---)%^^^^%)---)))$)))))))))))))))--+rr
))--%^^^^^^%^^^^^^^^^%))-)-+--%^^^%%))))))))))))))))))))))))-+rr
))--%^^^^^%)%^^^^^^^^^%)))---%^^^%))))----))))))))))))))))))--rr
))---%^^^%)))%^^^^^^^^^%%%%%%^^^%))))--++-)))))))))))))))))))-rr
))))-%^^%)))))%^^^^R^^^^^^^^^^^%)))))-+-+-))))))))))))))))))))rr
)))))%^^%)))))%^^^^^^^^^^^^^^^%)))))---++-))))))))))))))))----rr
))))))%^%)))---%^%%%%^^^^^^^^%))))))-+++--)))))))))))))))--+++rr
)))))))$))))-+-%%-)))%%^^^^^%)))))))--+++-)))))))))))))))-+++-rr
))))))))))))------)))))%%^^^%))))))))-+++-)))))))))))))))---+-rr
))))))))))))--+--))))))))%^^^%)))))))------)))))))))))))-))-+-rr
))))---))))%%----))))))))%^^^%)))))))))----))))))))))))-------rr
))))-+--)-%^^%))))))))))))%^^^%)))))))%%%--))))))))))))--++-))rr
))))-++--)%^^^%))----))))$^^^^%)))))))%%)))))))))))))))-+++--)rr
))))-+-+-)%^%%)))-+----)))%%%%-)-))))))))))))))))))))))--+-+-)rr
))))-+-+-))$)))))--+++--)))----)))))))))))))))))))))))))-----)rr
rrrrrrrrrrrrrrrrrrrrrrrrrrrrrrrrrrrrrrrrrrrrrrrrrrrrrrrrrrrrrrrr
rrrrrrrrrrrrrrrrrrrrrrrrrrrrrrrrrrrrrrrrrrrrrrrrrrrrrrrrrrrrrrrr
