))((%(%(%(((%%)))))))))))))%^((^^%))))%^^^^^^^%)))))))))--))))rr
)))))))))----))))))))))))))%((^(^^%%)))%^^^^^^%)))))))))----))rr
)))))))))-++--)))))$))))))%((^RR^^^^%%)%^^^^^^%))))))))---+-))rr
))))))))--+++-)))))%%)))))%(^^RrR(^^^^%^^^^^^^^%%%%%%()-++--))rr
))))))))-++----)-))(^%)))%%%%^^RR^^%^^^^^^^^^^^^^^^^^%)-++-)))rr
))))))))--+-)))----)%^%%%%---%^^^^%)%^^^^^^^^^^^^^^^^^%----)))rr
)))))))))---))--+++-)%^(%--+--%^%%)))%^^^^^^^^^^^^^^^^^%-+-)))rr
)))))))))))))))-++--))%%--+++--$-)))))%^^^^^^^^^^%%%%%%%-+-)))rr
)))))))))))))))---+-))))--++-+--))))))%^^^^^^^%%%--))))----)))rr
)))))))))))))))))-+--))))----++--)))))%^^^%%%%)----)))))))))))rr
)))))))))))))))))---))))))%%----))))))%^^%))))--+--)))))))))))rr
))%%%)))))))))))))))))))))%^%--)))))))%^%))))--++-)))))))))$%)rr
))%^%))))))))))))))))))))$^^^%)))))))%^^%))))-++--))))))))))$)rr
))%^^%))))))))))))))))))))%^^%)))))%%^^^^%))---+-)))))))))))))rr
))%^^^%%)))))))))))))))))))%%%))))%^^^^^^%))-+++--))))))))))))rr
))%^%%%%)))))))))))))))))))))))))%^^^^^^%)))--+-+-))))))))))))rr
)%%%))))))))))))))))))-))))))))))%^^^%^%%))))---+-))))))-)))))rr
)$)))))))))))))))))))----))%%)))))%%%)$)))))))----))))))))))))rr
)))))))))))))----)%%%-++-)%^%))))))))))))))$))))))))))))))))))rr
)))))))))))$)-+---%^%----%^^^%))))))))))))%^%)))))))))))))))))rr
)))))))))))%%-+--%^R^%---%^^^%-)))))$)))%%^^^%))))))))))))))))rr
)))))))))))%%-+--%^^^^%%%^^^^%)-)))%^%%%^^^^%%))))))))))))))))rr
))))))))))))$---$^^^^^^^^^^^%--))-%^^^^^^^^%))))))))))))))))))rr
))))))))))))))---%^^^%%%%^^^%--))%^^RRRR^^%)))))))))))))))))))rr
)))))))))))))))---%%%)---%^^%--))%^^^^R^^%))))))))))))))))))))rr
)))))))))%%%)))---)-))---)%^^%))%^%%%%^^%--)))))))))))))))))))rr
)))))))%%^^%)))-+---))))))%^^^%%^%))))%%--)))))))))))--)))))))rr
))))))$%^^^^%))-+++-))))))%^^^^^%)))--------))))))))---)))))))rr
))))))))%%%%%))-----)))))%^^^^^%))))-+-+----))))))))-+-)))))))rr
))))))------)))))---))))%^^^^^%)))-)--+---%%))))))))---)))))))rr
))))))-++++-)))))-%%%%%%^^^^^%))----)---%%^^%%)))))))--))-))))rr
))%%---+-----)))$%^^^^^^^^^^^%)--++----%^^^R^^%)))))))))))))))rr
)%^^%--+-))))))))%%%%%%^^^^^^^%)---+---%^^RrR^%)))))))))))))))rr
)%%%%%---))))))))))))))%%^^^^^^%%%---+--%^^RR^^%))))))))))))))rr
)$))-%%%-))))))))))))))))%^^^RR^^%----+-%^^RR^^%))))))))))))))rr
))))))%%))-))))))))))))))%^^^^RR^%)))-+-%^^^^^^%))))))))))))$)rr
))))))))))))))))))))))))))%^^^^^%))))---%^^^^^^^%))))))))))%^%rr
%%)))))))))))))))))$))))))%^^^^^%))))))%^^^^^^^^%)))))))))$^^^rr
^^%))))-))%%%)))))%^%))))%^^^^^^%)))))%^^^^^^^^^%))))))))))%^^rr
%%%))))---%^%)))))%^^%)))%^RR^^^%))))%^^^^%%%^^^^%)))))))))%%%rr
))))))--+-%^^%)))%^^^^%)%^RR^^^%-----%^^^%---%^^^^%)))))))))))rr
))))))--+-%^^%)))%%%^^^%^^R^^^^%-+-+-%^^^%--)%^^^^^%))---)))))rr
)))))))----%^%---)))%^^^^^^^^^%)--+---%^%)))-%^^^^^%---+-)))))rr
)))$)))))---$--+-))))%^^^^^^^^%)-++-+-%^%)))))%^^^^^%-+--)))--rr
)))%))))))----+---))))%^^^^^(^^%--++--%^%)))))%^^^^^%----))--+rr
)))%%)))))))-+-+----))%^^^^^^^^^%----%^^%)))))%^^^%%%%--)))---rr
)))%%)))))))---+--+--)%^^^^R^^^^^%%%%^^^^%%%%%^^^%)))%%%%%%%-+rr
)))%%)))))------++++-))%^^RRR^^^^^^^^^^^^^^^^^^^%)))))%^^^^%-+rr
))%^%))))--+-))-++++---%^^^^^%%%%%^^^^^^^^^%^^^^%)))))%^^^%%--rr
))%^%))))-++-))--+-+-+-%^^^%%)))))%^^^^^^^%)%^^^^%))))%^^%))))rr
))%^%))))-+--)%%--+--+-%^^%))))))))%^^R^^%)))%^^^^%%%%^^%))))-rr
))%^%))))-+-))%^%-++++-%^%))))))))%^^^^^^%))))%^^^^^^^^%)))))-rr
))%^%))))---))%^%--++--%%)))))))))%^^^^^%)))))%^^^^^^^^%))))--rr
)))$))))))))))%^%)----%^^%))))))%%^^^^^%))))))%^^^^%^^^%))))-+rr
)))))))))))))%^^^%)-)%^^^^%%%%%%^^^^^^%)))))))%^^^%)%^^^%%%)--rr
))))--)))))%%^^^^^%))%^^^^^^^^^^^^^^^%))))))))%^%%)))%^^^^^%%-rr
)))----))%%^^^^^^^%)))%%%%^^^^^^^^^^^%))))))---$)----%^^^^^^^%rr
%%%--%%%%^^^^^^^^%))---)))%^^^^^^^^^^%))))))-+--)-++-)%^^^^^^^rr
^^%%%^^^^^^R^^^^%)))-+--))%^^^^^^^^^%--)))))-++-------%^^^^^^^rr
%%---%^^^^RR^^^%))---++-))%^^^%%%%%%%--))))--+++-)))))%%%%%%%%rr
))---)%%%%%^%%%)))-++-+-))%%%%))))))---))))-+-+--))))))))----)rr
)))))))))))$))))))-++-+-)))))))))))))))))))-----))))))))--+--)rr
rrrrrrrrrrrrrrrrrrrrrrrrrrrrrrrrrrrrrrrrrrrrrrrrrrrrrrrrrrrrrrrr
rrrrrrrrrrrrrrrrrrrrrrrrrrrrrrrrrrrrrrrrrrrrrrrrrrrrrrrrrrrrrrrr
