)%^^^%))))))))%^^^^^^^%)%^^^^%))))))))))))))))%%---+-))%^^(^^(rr
)%^^^^%%))))))%^^^^^^^^%^^^^^^%)))))))))))))))%%--+--))%^^^(^(rr
)%%%^^^^%))))))%^^^R^^^^^^^^^^^%))))))))))))%%^^%----)%^^^^^^(rr
))))%^^^%))))))%^^^RR^^^^^^^^^^%))))))))))%%^^^^^%%--)%%%^^^^^rr
)))))%^%))))))))%^^RR^^^^^^^%^^%)))))))))%^^^^^^^^^%)))))%^^((rr
))))))%%))))))))%^^^^^^^^^%%)%%%))))))))%^^^^^^^^^%)))))))%^^^rr
)))))))%)))))))))%^^^^^^^%)-)))))))))))%^^^^^^^^^^%))))))))%^(rr
)))))))%%%%%))))))%^^^^^%---)))))))))))%^^^^^^^^^^%)))))))%^^^rr
)))))))%^^%%%)))))%^%%%%---))))))))))))%^%^%^^^^^%))))))))%^^^rr
)))))))%^%)))))))))$))---+-)))))))))))))$)))%^^^^%))))))))%^^^rr
))))))%^%)))))))))))))---+-))))))))))))))))))%^^^%))))))))%^^^rr
)))))$%%))))))))))))))))---)-)))))))))))))))))%%%))))))))%^^^^rr
)))$)))))))))))))))))))))))))))))))))))))))))))))))))))))%%%%%rr
)))%))))))))))))))))%%%%%%%))))))))))))))))))))))))))))%%%))))rr
)))%)))))))))))))))%^^^^^^^%%))))%%%%%%)))))))))))))))%^%)))))rr
))$^%)))))%%)))))))%^^^^^^^^^%%%%^^^^^^%)))))))))))))$^^%)))))rr
)))%%))))%^^%)))))))%%^^^%%%^%%%%^^^^^^%))))))))))))))%%))))))rr
)))))$))%^^^%)))))))))%%%)))$))))%^^^^^%))))))))))))))%%))))))rr
))))))%%^^^^%))))))))))))))))))))%^^^^^%))))))))))))))%%))))))rr
))))))%^^^RR^%)))))))))))))))))))%^^^^^%)))))))))))))))$))))))rr
)))))))%^^RR^%))))))))))))))))))%^^^^^^^%)))))))))))))))))))))rr
))))))%^^^^^^^%)))))))))))))))))%^%%^^^^%)))))))))))))))))))))rr
)))))%^^^^^^^^^%)))))))))))))))))$))%^^^%)))))))))))))))))))))rr
))%%%^^^^^%%%%%%)))))))))))%%%)))))))%^^%)))))))))))))))))))))rr
)%^^^^^^^%)))))))))))))))))%^^%%))))))%^%)))))))))))))))))))))rr
)%%%%^^^^%))))))))))))))))))%^^^%)))))%^%)))))))))))$)))%%))))rr
)))))%^^%)))))))))%%%))))))))%^^^%)))%^^^%%))))))))%^%%%^%))))rr
))))))%^%))))))))%^^^%))))))))%^%%)))%^^^^^%%)))))%^^^^^%)))))rr
))))))%%))))))))%^RR^%)))))))))$)))))%%^%%%%%%)))%^^^%%%))))))rr
))))))%%))))))%%^R^^^^%))))))))))))%%))$)))))%%%%^^^%)))))))))rr
)))))%^%))))))%^R^^^^^^%%%%%)))))))%%)))))))))%^^^%%))))))%%%)rr
)))))%^%))))))%^^^^^%%%%%^^%))))))$^%))))))))))%%%)))))))%^^^%rr
))))))%%))))))%^^^^%)))))%%%)))))))$)))))))))))))))))))))%%^^%rr
))))))))))))))%^^^^^%))))))))))))))))))))))))))))))))))))))%%)rr
)))%%))))))%%))%^^^^%)))))))))))))))))))))))))))))))))))))))))rr
))%^%)))))%^^%%^^^^^^%))))))))))))))))))))))))))))))))))))))))rr
)%^%))))))%%^^^^^^RR^%))))))))))))))))))))))))))))))))))))))))rr
)%%)))))))))%^^^^^^^^^%)))))))))))))))))))))))))))))))))))))))rr
)$)))))))))))%^^^^^^^^^%)))))))))))%%%%%))))))))))))))))))))))rr
))))))))))))))%^^^^^%%^%)))))))))))%^%%%))))))))))))))))))))))rr
))))))))))))))%^^^^%))$))))))))))))%%))))))))))))))))))))))))%rr
))))))))))))))%^^^%))))))))))))))))))))))))))))))))))))))))))%rr
)))))))))))%%%^^^%)))))))))))))))))))))))))))))))))))))))))))%rr
))))))))))%^^^^^^%))))))))))))))))))))))))))))))))))))))))))))rr
)))))))))%^^^^^^%)))))))))))))))))))))))))))))))))))))))))))))rr
))))%%%%%^RR^^^^%)))))))))))))))))))))))))))))))))))))))))))))rr
)))%^^^^^RrR^^^%))))))%%))))))))))))))))))))))))))))))))))))))rr
))%^^^^RRrrrR^^%))))))%%))))))))))))))))))))))))))))))))))))))rr
)%^^^^^^RRRR^^%)))))))))))))))))))))))))))))))))))))))))))))))rr
)%^^^^^^^^(^^%))))))))))))))))))))))))))))))))))))))))))))))))rr
)%%^^^^^^^^^%)))))%%%)))))))))))))))))))))))))))))))))))))))))rr
)))%^^^^^^^^%))))%^^^%))))))))))))))))))))))))))))))))))))))))rr
)))%^^^^^^^%)))))%^R^%))))))))))))))))))))))))))))))---)))))))rr
)))%^^^^^^%))$)%%^^R^^%)))))))))))))))))))))))))))))-+--))))))rr
)))%^^RR^%))))$^^^^^^^^%)))))))))))))))))))))))))))--+--))))))rr
))))%^^^%))))))%^^^^^^^%)))))))))))))))))))))))))))-+++-)))%%)rr
)))))%%%%)))))-%^^^^^^%%)))))))))))))))))))))))))))-+---))%^%)rr
))))))))))))))--%^^^^%)))))))))))))))))))))))))))))-))))))%^%)rr
)))))))))))$)----%^^%))))))))))))))))-)))))))))))))-))))))%^%)rr
))))))))))$^%-++-%^^%))))))))))))))))-----))))))))))))))))%%))rr
)))))))))))%%-----%%%))))))))))))))))-+++--)))))))))))))))))))rr
)))))))))))))))---)))))))))))))))))))-++++-)))))))))))))))))))rr
rrrrrrrrrrrrrrrrrrrrrrrrrrrrrrrrrrrrrrrrrrrrrrrrrrrrrrrrrrrrrrrr
rrrrrrrrrrrrrrrrrrrrrrrrrrrrrrrrrrrrrrrrrrrrrrrrrrrrrrrrrrrrrrrr
