)))%^%)))))))))))))))%%^%%%%%^%)))))))))))---))-+++-+-)))%%)))rr
)))(%))))))))))))))))))$)----%^%))---))))))))))--+++--))))))))rr
)))%%))))))%%%(%%)))))))--++-)%%))-+---)))))))))--++-)))-----)rr
)))%%)))))%^%(%%))----))-+++-)%%))-+++-)))))))))-+++-)))-+-+-)rr
))))$)))))%%)))))--++-))-----))%%--+++-)))))))))-----)))--++-)rr
))))))))))))))))))----))))))))%^%-+-++-))))))))-))))))))--+--)rr
)))))))))-----))))-))))%%))))%^^%---+--)))))))----))))%%)---))rr
)))))))))-+++--)))-----%%%%%%^^^%))---))))))))-++--%%%^^%)))))rr
)))))))----+++-))--+-+-))%^^^^^^%-))-))))))))--+--$%%%%%))))))rr
)))))----++++++---+++--)))%^^^^^%---)))))))))-++-$-)))))))))--rr
)))))--$-+++++++-----+-)))%^^^^^%-+--)%%)))))-----))))))))))-+rr
)))))--$-+++++++-)%%---)))%^^^^^%-++-)%^%)))))-$-)))))))))))--rr
))))-------+++---%^^%-)))%^^^^%%-----))$))))))%^%))))))))))$)-rr
)-))-+++++++-+--%^^^%))))%^^^%))---)))))))))))%^%))))))))))%%)rr
)))))))))))))))%^^^%-))))%^^%))))))))))))))))%^^^%%))))))))%%)rr
++-)----+----%%^^^%)))))))%%))))))%%%))))))))%^^^^^%))))))%^^%rr
+--))))-+-)--%^^^%)))))))))%))))))%^%))))))))%%^^^^^%)))))%(^^rr
-+-))))---))$)%%%))))))))))%%%)))%^^%))))))))))%^^^^%))))))%%%rr
---))))))))%^%)))))))))))))%^^%%%^^^%)))))))))))%^^^^%))))))))rr
)))))))))))%^^%))))))))))))%^^^^^^^^%---)))))))))%^R^%))))))))rr
))))))))))%^^^^%)))))))))%%^%%%^^^^^%-+--))))))))%^^^%))))))))rr
))))))))))%^^^^%))))))))%^^%)))%%^^^%-++-)))))))-%%%%%))))))))rr
))))))))))%^^^^^%)))))%%^^^%)))))%^^%-+--)))))))------)))))%%)rr
)))))))))$^^^^^^^%%%%%^^^^^%--)))%^^%-----))))))---+--))))%^^%rr
))))))))))%^^^^^^^^^^^^^^^%--$))%^^^%-++---)))))--++-))))%^^^^rr
%))))))))))%%^^^^^^^^^^^^%---%%%^^^%--++---%%%%%)--+-)))%^^^^^rr
^%%%)))))))))%^^^^^^^^^^%))--)%^^^^%-+-++-%^^^^^%--+-)%%^^^^^^rr
^^^^%%))))))))%^^^^^^^^^%))-))%^^^^%------%^^^^^^%-+--%^^^^^^^rr
%%^^^^%))))))))%%^^^^^^%)))))))%%%^^%)))-%^^^^^^^%---))%%%^^^^rr
))%^^^^%)))))))))%^^^^^%--------))%^^%))%^^%^^^^^%))))))))%^^^rr
))%^^^^^%)))))))))%^^^%)------+-))%^^^%%^^%)%^^^^^%%))))))%^^%rr
))%^^^^^%)))))))))%^^^%)%%%%%---)%^^^^^^^%)))%^^^^^%))))))%^^%rr
))%^^%%%))---))))%^^^^^%^^%%%%--)%^^^^^^^%))))%^^^^^%%)))%^%%-rr
)))%%)))---+-)))%^^^^^^^^%)))%%%%(^%^^^^^^%)))%^^^^^^^%%%^%---rr
))%^%)))-++--)%%^^^^^^^^%---))%^^^%)%^^^^^^%%%^^^^^^^^^^^%)---rr
))%^%)))--+--%^^^^^^^^^^%-+-)))%^%)))%^^^^^^^^^^^^^^^^^^%)))))rr
)%^^^%))-++--%^^^^^^^^^%----)))%%-)))%^^^^^^^^^^^^%%%^^^%)))))rr
)%%%%%))-----%^^^^^^^^^%-+---)-----))%^^^^^^^^^^^%)))%^^%))-))rr
)$)))))))-))%^^^^^^^^^^%-++-))-+++--%^^^^^^^^^^^%)))))%^%)))))rr
)))))))))%%%%^^^^^^^^^^%----)--++--%^^^^^^^%%^^%)))))-)$))))))rr
))))))))%%)))%^^^^^^^^^%-+-)))-++--%^^^^^^%))%%%))))------))))rr
%)))))%%^%)))%^^^^^^^^^%---)))-+--%^^^^^^%))))))))))-+-+-)))))rr
^%%%%%^^%)))))%^^^^^^%%---))))---)%^^^^^%))))))))))--+++-)))%%rr
^^^^^^^^%))))))%%%%%%-----)))))))%^^^^^%))))))))))--++++-)%%^^rr
%^^^^^^%))))))))))))))---))))))))(^^^^%%)))))))))))---+--%^%%^rr
)%^^^^^%))))))))))))))))))))))))%^^^%%)))))))))))))))---%^%))%rr
)%^^^^%))))))))))))))))))))))))%^^^%---)))))))))))))))%%^%))))rr
)%^^^^^%)))))))))))))))))))))))%^^%--+--))))))))))))))%^%)))--rr
)%^^^^^%)))))))))))))))))))))))%^^%---+-))))))))))))))%^%))--+rr
))%^^^^^%%%)))))))))))))))))))%^^^^%----))))))))))))))%^%))---rr
))%^^^R^^^^%%)))))))))))))))%%^^^^^^%--))))))))))))))%^^^%%%--rr
))%^^^^RrRRR^%)))))))))))))%(^^^^^^^%)))))))))))))%%%^^^^^^^%-rr
)%^^^^^RRRRR^^%))))))))))))%%%%^^^(^^%))))))))))%%^^^^^^^^^^^%rr
##^^^^^^^^^^^^^%%%%))))))))))))%%(%^^^%)))))))%%^((^^^^^^^^^^^rr
##^^^^^^^^^^^^^^^^^%)))))))))))))))%^^%)))%((%^^^((^^^^^^^^^^^rr
%%^^^^^^^^^%%^^^^^^^%)))))))))))))))%^^%%%^^^^^^^^^^^^^^^^^^^^rr
))%^^^^^^^%))%%^^^^^%))))))))))))))%^^^^^^^%%%(%%%%%%^^^^^^%%%rr
--%^^^^^^^%))))%%%^^%)))))))))))%%%^^^(^^^%))))))))))%^^^^()))rr
--%^^^RR^^%)))))))%^%)))))))%%%%^^^^(^^^^%))))))))))))%^^%))))rr
+--%%^^^^%))))))))%%)))))))$%%%%%%%%%%%%%))))))))))))))%%---))rr
++--)%%%%))))))))))))))))))))------)-)))))))))))-)))))----+-)-rr
+++-)))))))))))))))))))))))))--+---)))))))))))-)))-)))-++++-))rr
rrrrrrrrrrrrrrrrrrrrrrrrrrrrrrrrrrrrrrrrrrrrrrrrrrrrrrrrrrrrrrrr
rrrrrrrrrrrrrrrrrrrrrrrrrrrrrrrrrrrrrrrrrrrrrrrrrrrrrrrrrrrrrrrr
