))hhh))))))hhhhhhhhhhhhhhhh)))))))))))^^^^^^^^^)^^^^^^^^^^^))))
)))))))))))hhhhhhhhhhhhhhh))))))----))^^^^^^^^^^^^)))^^^^^^^^))
))))))))))hhhhhhhhhhhhhhh)))))hh-----)^^^))))^^^^^))))^^^^^^^))
))^^^)))))hhhh)))hhhhhhh)))^)))h----^--)))))))^^^)))))^^^^^^^^)
)))^^)))))hhhh))))hhh)))))^^)))))------)))))))^^^))))))^^^^^^))
)))))))))hhhh)))))hh)))))^)))))))------))))))^^^^)))))^^^^^^^))
))))-----hhhh)))))hh)))^^)))))))))----)hh))^^^^^^^)))^^^^^^^^))
)hhh-----hhhh)))))hhh))^)))h))))))----))))^^^^^^^^^^^^^^^^^^^))
hhhh-------hh)))))hhh)))))hhh))^^)-----))^^^^^^^^^^^^^^^^^^^---
hh))-------h)))))))hhh)))hhh))^^^^----)^^^RR^^^^^^^^^^^R^^^----
h)))-------))))^)))hhhhhhhhh))^^^^--)^^^^RRR^^^)))))^^RR^^-----
)))^))----))))^^)))hhhhhhhhh))^^^)))-^^^RRRR^^^))))))^^^^^-----
))^^^)---))))))^))hhhhhhhh)))))^)))))^^^RRRR^^)))))))^^^^------
))^^^^))))))))))^^hhhhh))))))))))))))^^^^RR^^^))))))))^^)------
))^^^^^^^^^^^))-^^hhhh)))))))))))))))^^^^^^^^)))))))))))))))-))
)^^^^^^^^^^^^^----hhh)))))))))))))))^^^^^^^^^^))))))))))))^^^))
)^^^^^^^^^^^^^-----))))))))^^^))))^^^^^^^^^^^^)))^^^))))))^^^))
^^^^^^^^^^^^)------)))))))))^^^^^^^^^^^^^^^^^^^^^^^^^)))))^^^^)
^^^^^^^^^^)))------))))))))))^^^^^^R^^^^^^^^^^^^^^^^^))))))^^^^
^^^^^^^^^)))------^^^))))))))^^^^RRRR^^^^^^)^^^^^^^^^)))))))^^^
^^^^^^^^^)))))----^^^^))))))))^^^RRR^^^^^)))))^^^^^^^)))))))^^^
^^)))^^^^))))))---^^^^^^))))))^^^^^^^^))))))))))))^^))))))))^^^
^)))))^^^))))))))^^^^^^^^^^^^^^^^^^^^))))))))))))))^)))hh)))^^^
^)))))^^^))))))))^^^^^^^^^^^^^^^^^^^^))))))^)))h)))^)))hh)))^^^
^))))))^))))))))))^^^^^^^^^^^^^^^^^^^^))))^^^)))))^^^))))))^^^^
^)))))))))))))))))^^^))))))^^^^^^^^^^^^)^^^^^)))))^^^)))))))^^^
^^^))))))))^))))))^^^)))))))^^^^^^)))^^^^^^^)))))^^^^^))))))^^^
^^^^))))))^^^)))))^^^))))----^^^^))h))^^^^)))))))^^^^^)))))))^^
^^^^)))))^^^^^)))^^^^))))-----^^))hhh)))))))))))))^^^^^^))))))^
)))))))))^^^^^)))^^^^))))-----)))hhh-)))))))))))))^^^^^^^^^))))
)))))))))^^^^^^^^^^^^^)))----))hh---))))))))))))))^^^^^^^^^^)))
))))))))^^^^^^^^^^^^^^)))))))))hh)))-)))))))))))))^^^^^^^^^^^))
)))))))^^^^^^^^^^^^^^^))))))))))))))))hh)))))))))^^^^^^^^^^^^^^
)))))^^^^^^^^^)))^^^^))))))^^^))))))))hhh)))^))))^)))^^^^^))))^
^^)^^^^^^^^^^^)))))))))))))^^^^^^^^^))hhh))^^^^^))))))^^^)))))^
^^^^^^^^^^^^^)))))))))))))^^^^^^^^^^))hhh))^^^^^)))h)))^)))h)))
^^^^^^^^^^^^^^))))))))))))^^^^^^^^^^))hhh)))^^^^))))))))))hhh))
))^^^)))))^^^^))))))))))))^^^^^^^^^^))hhh))))^^^))))))))))hhh))
)^^^^)))))^^^^^))^^^)))))^^^^^^^^^^)))hh---)))^^))))))))))hhh))
)^^^^^))))^^^^^^)^^^^))))^^RR^^^^^))-------))))^^^^^^)))))hhh))
)^^^^^)))^^^^^))))^^^))))^^RR^^^^^)--------))))^^^^^^)))))hh)))
)^^^^^^)^^^^^)))))^^^))))^^^^^^^^))--------)))))^^^^^))))h)))))
--^^^^^^^^^^^)))))^^^)))))^^^^^^^))--------h))))^^^^^)))---))))
--^^^^^^^^^^^)))))^^^)))))^^^^^^^))))------hh)))^^^^^))h----)))
---^^^^^^^^^^)))))^^^^)))^^^^^^^^)))))-----hh))))^^^^))-----)))
-^-))^^^^^^^^^)))^)))^^^^^^^^^^^^)))))))-hhhhh)))^^^^))hh---)))
^^))))^^^^^)^^^^^)))))^^^^^^^^^^^^))))))hhhhhh))))^^^))hh))))))
-)))))^^^^))))^^)))h))^^^^^^^^^^^^^^)))))hhhhh))))^^^))hhhh))))
))))))^^^^))))))))h)))^^^^^^^^^^^^^^^)))))hhh))))^^^^))hhh)))))
))))))^^^^)))))))h)))^^^^^^^^^^^^^^^^^^)))))))))^^^^^))))))))))
))))))^^^^)))))hh)))^^^RRRRR^^^^^^^^^^^^)))))))^^^^^^))))))))))
)))))))^^^^))))h)))^^^^RRRRR^^^^^^^^^^^^^))))^^^^^^^^)))))^^^))
))))))))^^^^))))))^^^^^^^^^^^^^^^^^^^^^^^))))^^^^^^^^^)))^^^^))
))))h)))))^^^)))))^^^))^^^^^^^^^)^^^^^^))))))^^^^^^^^^^^^^^^^))
))))h))))^^^^^)))^^^^)))))^^^^)))))^)))))))))^^^^^^^^^^^^^)))))
)))))))))^^^^^)))^^^^))))))^^^)))))))))))))))^^^^^^^^^^^^))))))
)))))))))^^^^^^))^^^^))h))))^^))))))))))))))))^^^^^^^^^^^))))))
)))))))))^^^^^)))^^^^))hh))))^^^^^))))))))))))^^^^)))^^^^))))))
)))))))))^^^^^)))^^^^))hhhh)))^^^^-)))hhh))))^^^^)))))^^^^^^^))
--^^))))))^^^)))))^^))hhhhhh))^^^--)))hhh)))))^^)))))))^^^^^^))
----))))))))))))))))))hhhhhhh))-----)hhhh)))))))))hhh))))))))))
----))))))))))))))))))hhhhhhhh))---)hhhhh))))))))hhhhh)))))))))
----)))h)))))))h))))))hhhhhhhhh))hhhhhhhhhhhhh))hhhhhhh))))))))
