(%)%%^^^^^%%)%%((%%%)))))%^^^%)))%^^%)))))))))--+-))))))))))))rr
)))))%^^^%)))))))))))))))%^R^^%))%^^%)))))))))-++-))))))))))))rr
))))))%^%))))))))))))))))%^RR^^%%^^^%)))))))----+-)%%%%%%%%%))rr
))))))%^%))))))))))))))))%^R^^^((^^^%)))))%%%-+++-%^^^((^(^^%)rr
)))))))%)))))))))))))))))%^^^^(^^^%%))))))%(%--++-%^(^^^^^^^^%rr
))))))%%)))---)))))))))))%^^^(((^%))))))))%^%)-+--%^^^(^^^%%%^rr
%))))%^%)))-+----))%%))))%%%%((^%))))))))))%%)---)%^^^^^^%)))%rr
(%%%%^^%--)--+++-)%^^%)))))))%%%)))))))))))%%)))))%^^^^^^%))))rr
((^^^^%-----+++--)%%%%)))))))))))))))))))))%%)))))%%%^^^%)))))rr
^(^^^%--+++-+++-)))))))))))))))))))))))))))%^%)))$)))%^^%)))))rr
^^^^%--++-----+-)))))))))))))))))))))))))))%^^%%%)))))%%%%%%%%rr
^^^^%-+++--$----)))))))))))))))))))$))))))))%%%%)))))))))%^^^^rr
^^^^%-----%^%%))))))))))))))))))---%%)))))))))))))))))))))%^^^rr
^^^^%)-)))%^^^%)))))))---))))))--+---))))))))))))))))))))))%^^rr
^^^^^%))))%^^^^%%)))))-+-))))))--+++---)))%%)))))))))))))))%^^rr
^^^^%)))))%%%^^%))))))-+-))))))-+++--+-)))%%)))))))))))))))%^^rr
^^^^%))))))))%%)))))))-+-))))))---+----)))))))))))))))))))$^^^rr
^^^^%)))))))))))))))))-+-)))---))---)))))))))))))))))))))))%^^rr
^^^^%)))))))))))))))))---)))-+--)))))))))))))))))))))))))))%^^rr
^^^^%)))))))))))))))))))))))--+--)))))))))))))))))))))))))))%%rr
%%%%%)))--)-))))))---))))))))----)))))))------))))))))))))))))rr
)))))))))-)))))))--+---))))))-++-))$))))-+-+-)))))))))))----))rr
)))))))))-)))))))-++++-))))))----))%))))-+++-)))))))))))-++---rr
))))))))))%%%%%%)--+++-))))))))))))%%)))-----))))))))))--+-++-rr
)))))))))%^^%%%)))--+--))))))))))))%^%))--)--)))))---))-++++++rr
))))))))%^%%))--))-++-)))))))))))))%^^%%))))))))))-+----------rr
)))))))%^%))))))))----)))))$))))))))%^^^%)))))))))-+++-)-+---)rr
))----)%^%))))))))))))))))%^%))))))))%^^%)))))))))---------%%)rr
---++--%^%))))))))%%%))))%^^^%))))))))%%))))))))))))))-+++-%%)rr
)-+++--%^%)))))))%^^%))))%^^^%))))))))))))))))))))))))-++--%^%rr
)--++-%^^%))))))%^^^^%))))%%%%))))))))))))))))))))))))-+++-%^^rr
)--++-%^^^%)))))%^^^^%))))))))))))))))))))%%)))))))$))------%%rr
)-+---%^^^%))))))%%%%))))))))))))))))))))%^^%)))))%^%))))----)rr
)---))%^^^^%)))))))))))))))))-------))))%^^^^%)))%^^^%))--+--)rr
))))))%^^^^%))))))))))))))))--++--+-))%%^^^%^^%%%^^^^^%%----))rr
))))))%^^^^^%))))))))))))))))-++-+--))%^^^%)%%%^^^^^^^^^%-+-))rr
))))))%^^^^^%))))))))))))))))------)))%^^^%))))%%%%%^^^%----))rr
))))))%^^^^^^%))))))))))))))))-%%-))))%^^^^%))))))))%%^%-+-)-)rr
))))))%^^^^^^^%%)))))))))))))))%%)))))%^^^^%))))))))))%%---)))rr
))))))%%%%%%^^^^%)))))))))))---%%)))))%^^^^^%))))))))))%))))))rr
))))))))----%^^^%)))))))))))---%%))))))%%%^^%))))))))))%))))))rr
)))))))--++--%^^%)))))))))))-+---)))))))))%%))))))))))%^%)))))rr
)))))))-+-++-%^^%)))))%%%%%)-----)%%)))))))))))))))%%%^^^%))))rr
))))-))-++++--%^%)))))%^^^^%%%--%%^^%)))))))))))))%^^^^^^^%)))rr
)))-)---++++--%^%))))))%^%%%%^%%^^^^%))))))%%)))))%^%%%%%%^%%)rr
)))))--------)%^%)))))))$))-)%%^^^^%%))))))%^%)))%%%))))))%^^%rr
)%%%%%%%%%%%%%^^^%%))))))))))))%^^%)))))))%^^^%%%%))))---)%^^^rr
%^^^^^^^^^^^%^^^^^^%%))))))))))%^^%)))))))%^^^^^%)))))-+--%^^^rr
^^^^^^^^^^^%)%%%%%^^^%)))))))))%^^^%)))))%^^^^^%)-))))-+-$^^^^rr
^R^^^^^^^^%)))))))%^^^%%)))))))%^^^^%%%%%^^^^^%)))-----+--%^^^rr
^R^^^^^^^%)))))))%^^^^^^%%%%%%%^^^^^^^^^^^^^^%)))--+--+++-%^^^rr
^^^^^^^^%)----))-%^RR^^^^^^^^^^^^^^^^^^^^^^^^%)-)-++----+-%^^^rr
%%^^^%%%)))-+---)%^^R^^^^^^^^^^^^^^^^^^^^^^^^%)))----))---%^^^rr
))%^%))))))---)))%^^^^^%%^^^^^^^^^%%%^^^^^^^^^%))))))-))))%^^^rr
))%^%))))))--)-)))%^^^%))%^^^^^^^%)))%^^^^^^^^^%%%%--)))))%^^%rr
)%^^%)))))))))))))%^^%))))%%%^^%%)))))%^^^^^^^^^^^^%))))))%^^^rr
%^^^^%)))))))))))%^^%))))))))%%))))))))%^^^^^^^^^^^^%))))%^^^^rr
^^##^^%)))))))))%^^^%)))))))))))))))))))%^^^^^%%%^^^()))(^^^^^rr
^^##^^^%%%%%%%%%^^^^%))))))))))))))))))))%^^^%)))%^^((%((^^^^^rr
%%%%%%%^^^^^^^^^%%%%))))))))))))))))))))))%%%)))))%%%%%%%%%%%%rr
)))))))%%%%%%%%%))))))))))-----))))))---))))))))))))))))))))))rr
))))))))))))))))))))))))))-+-+--)))))-+-))))))))))))))))))))))rr
rrrrrrrrrrrrrrrrrrrrrrrrrrrrrrrrrrrrrrrrrrrrrrrrrrrrrrrrrrrrrrrr
rrrrrrrrrrrrrrrrrrrrrrrrrrrrrrrrrrrrrrrrrrrrrrrrrrrrrrrrrrrrrrrr
