)))))))))))))))))%^^^%)))%^^^%%))))))))))))))-++++-)))))))))))rr
))))))))))))))))))%^%)))))%^%))))))))))))))))-+----)))))))))))rr
))))))))))))))))))%%)))))))%%))))))%%))))))))---+-))))))))))))rr
))))))))))))))))))%%)))))))%%)))))%(^%%)))))))----)$))))))))))rr
))))))))))))))))))%^%)))))$^%)))))%%(^%))))))---+-))))))))))))rr
))))))))))))))))))%^%))))))%^%))))))%^(%))))--++--))))))))))))rr
)))))))))))))))))))%%)))))))$))))))))%%%))))-+++---)))))))))))rr
)))))))))))))))))))$))))))))))))))))))))))))---+++-)))))))))))rr
)))))))))))))))))))))))))))))))))))))))))))))------)))))))))))rr
)))))))))))))))))))))))))))))))))))))))))))))))-))))))))))))))rr
)))))----)))))))))))))))))))))))))))))))))))))%%))))))))))))))rr
))))--++--)))))))))))))))))))))))))%%)))))))))%^%)))))))-)))))rr
)))))-+++-))))))))))))))))))))))))%^^%))))))))%^%)))))))))))))rr
)))))-+++-))))))))))))))%%%%%%)))%^^^^%)))))))%^%)))))))))))))rr
))))))))))))))))))))))%%^^^^^^%%%^^^^^^%%)))))%^%))))))-------rr
)))))))---------))))))%^^^^^^^%%%%^^^^^^%)))))%^%)))))--+--+-+rr
))))))))))-+-++--))))))%^^^^%%))))%%^^^^%))))%^^%)))))-++++---rr
))))))))))-+-----))))))%^^^%))))))))%^^^^%))%^^^%)))))---+---+rr
))))))))))---)-%%%%%))))%^^%)))))))))%%^^^%%^^^^^%%%%%%%-+-)-+rr
)))))))))))))))%^^^^%%%)%^^%)))))))))))%%^^^^^^^^^^^^^^%------rr
)))))))))))))))%%^^^^^^%^^^^%))))))))))))%^^^^^^^^^^^^^^%-))))rr
)))))))))))))))))%^^^^^^^^^^^%))))))))))))%^^^^^%%%%%^^^%)))))rr
))))))%%%%)))))))%^^^^^^^^^^^^%))%%%)))))))%^^^%)))))%^^%)))))rr
%)))))%^^%))))))))%^^^%%%^^^^%%%%%^%)))))))%^^^%)))))%^^%)))))rr
%)))))%^%)))))))))%^^%))-%^^%)))))%^%))))))%^^^^%)))))%%))))))rr
%)))))%^%)))))))))%^%)))-)%^%)))))%^%))))))%^^^^^%%)))))-----)rr
^%%%%%^^%)))))))))%%))))-))%)))))))%%))))))%^^^^^^^%%)))-+-+--rr
^^^^^^^^^%))))))))%^%)))))%%)))))))%%))))))%^^^^^^^^^%))-+-+--rr
^^^^^^^^%))))----)%^%)))-)%%)))))))%%))))))%^^^^^^^^^%))-+++-%rr
^^%%%%^^%))))-++-%^^^%)--$-)))))))))))))))%^^^^^^^^^^%))--+--%rr
^%))))%^%))))-++-%^^^^%%---))))))))))))))%^^^^%%%^^^^%)))---)%rr
^%)))))$)))))--+--%%%%%----))))))))))))))%^^^%)-)%^^^%)))))))%rr
^%))))))))))))-----)))--+-))))))))))))))))%%%%))))%^^^%%)))))%rr
^^%)))))----))-)---)))----))))))))))))))))))----)))%^^^^%%^^^^rr
^^^%%%%%-----)))))%%)-)-))))))))))))))))))))-++-))))%^^^^^^^^^rr
RR^^^^^^%%%%))))))%%))))))))))))))))))))))))----)))))%^^^^^^^^rr
rrR^^^^^^^%^%%)))%^%)))))))))))))))))))))))))-))))))))%^^^^^^^rr
rR^^^^^^%%)%%^%%%^^%)))))))))))))))))))))))))))))))))))%%^^^^^rr
RR^^^^^%)))))%^^^^^%)))))))))))))))))))))))))))))))))))))%^^^^rr
^^^%^^%))))))%^^^^^%))))))))))))))))))))))))))))))))))))))^^^^rr
^%%)%^%)))))))%^^^^%))))))))))))))))))))))))))))))))))))))^^^^rr
%))))%^%)))))))%^^^%))))))))))))))))))))))))))))))))))))))%^^^rr
))))))%^%)))))))%^^%))))))))))))))))))))))))))))))))))))))%^^^rr
)))))))%%))))))))%^%)))))))))))))))$))))))))))))))%%%)))))%^^^rr
)))))))%^%))))))))%%%))))))))))))))%%)))))))))))))%^%)))))%^^^rr
))))))%^^^%))))))))))))))))))))))))))$)))))))))))%%%))))))%^^^rr
))))))%^^^^%))))))))))))))%%%)))))))))%%)))))))%%%)))))))%^^^^rr
)))))))%^^^%))))))))))))))%^%)))))))))%^%%%%%%%^^%)))))))%^^^^rr
))))))))%%%%%))))))))))))%^^%))))))))))%^^^^^^^^^%))))))))%%%%rr
))))))))))))))))))))))))%^^^%))))))))))%^^%%%^^^^%))))))))))))rr
)))))))))))))))))))))))%^^^^%)))))))))%^^%)))%^^^^%%))))))))))rr
)))))))))))))))))))))))%^^^^%)))))))))%^%)))))%%%^^%))))))))))rr
)))))))))))))))))))))))%^^^^%))))))))%^^%))))))))%^^%)))))))))rr
))))))))))))))))))))))))%^^^%)))))))%^^^%)))))))))%^%)))))))))rr
%))))))%%)))))))))))))))%^^%)))))))%^^^^^%%))))))))%%)))))))))rr
^%%%%%%^^%))))))))))))))%^^%))))))%^^^^^^^^%))))))%^^%))))))))rr
^^^^^^^^%))))))))))))%%%^^%))))))%^^^%%%%%^^%)))))%^^%))))))))rr
^^^^^^^^%)))))))))%%%^^^^%))))))%^^^%)))))%^^%)))%^^^^%)))))))rr
^^^^^^^%)))))))%%%^^^^^^^%))))$%^^^%))))))%^^^%%%^^^^^^((%%%%%rr
^%%%%%%))))))))%%^^^^^^%%))))))%%%%)))))))%%%%%%%%%%%%%%%%%%%%rr
%))))))))))))))))%%%%%%)))))))))))))))))))))))))))))))))))))))rr
))))))))))))))))))))))))))))))))))))))))))))))))))))))))))))))rr
rrrrrrrrrrrrrrrrrrrrrrrrrrrrrrrrrrrrrrrrrrrrrrrrrrrrrrrrrrrrrrrr
rrrrrrrrrrrrrrrrrrrrrrrrrrrrrrrrrrrrrrrrrrrrrrrrrrrrrrrrrrrrrrrr
