)%%%%)))))))))%^%)))))))))))))))))))))))))))))))))))))))))))))rr
)$))))))))))))%^%)))))))))))))))))))))))))))))))))))))))))))))rr
)))))))))))%%%^^(%%%%%%%%%%)))))))))))%%%%%)))))))))))))))))))rr
))))))))))%^^(^^^^^^^^^(^^^%)))))))))$^^(^^%%)))))))))))))))))rr
)))))))))%^(^(^(^^^%%%(%%^(^%)))))))))%%%(%%^%))))))))))))))))rr
))))))))%^^^^^%%%%%))))))%^^%)))))))))))))))%^%)))))))))))))))rr
))))))%%^^^^^%))))))))))))%^%))))))))))))))))%^%))))))))))))))rr
))))))%^^^%%%)))))))))))))%^(%))))%%))))))))))%%))))))))))))))rr
)))))))%%%))))))))))))))))%^(^%))%^^%)))))))))))))))))))))))))rr
))))))))))))))))))))))))))%^(^^%%^^^^%%)))))))))))))))))))))))rr
)))))))))))))))))))%%))))%^^^^(^(^^^^^^%%%%%))))))))))))))))))rr
)))))))))))))))))))%^%)))%^(^^%%%%^^^^^^^^^%))))))))))))))))))rr
))))))))))))))))))%^^^%)%^^^^%))))%%^^^^((^%))))))))))))))))))rr
))))))))))))))))))%^^^^%^^^(%)))))))%^^^((^%))))))))))))))))))rr
))))))))))))))))))%^^^^^^^^%)))))))))%^^^^^%))))))))))))))))))rr
)))))))$))))))))))%^^^^^^^^%))))))))))%%^^^^%)))))))))))))))))rr
))))))))))))))))))%^%%%%%%^^%)))))))))))%%^^%)))))))))))))))))rr
)))))))))))))))))))$))))))%^%)))))))))))))%^^%))))))))))))))))rr
))))))))))))))))))))))))))%^%)))))))))))))%^^%)))))))))%%%%%))rr
)))))))))))$))))))))))))))%^%)))))))))))))%^^^%))))))))%^^^^%)rr
)))))))))))$))))))))))))))%^%)))))))))))))%%%^^%)))))))%%%%%%)rr
))))))))))))))))))))%%)))%^%)))))))))))))$)))%^%))))))))))))))rr
)))))))))))))))))))$^^%%%^^%))))))))%%%%%)))))%^%)))))))))))))rr
))))))))))))))))))))%%%^%^^%)))))))%^^^^%)))))%%%)))))))))))))rr
)))))))))))))))))))))))$)%^%)))))))%^^^^%)))))))))))))))))))))rr
)))))))))))))))))))$))))))%%))))))))%^^^%)))))))))))))))))))))rr
)))))))))))))))))))%)))))))%)))))))))%^^%))))))))))%%%)))%%)))rr
))))))))))))))))))%^%)))))%^%)))))))))%^%)))))))))%^^^%%%^%%))rr
))))))))))))))))))%^%)))))%^%)))))))))%^^%)))))))%%%%%)))$))))rr
)))))))))))))))))%%%%%)))%^^%)))))))))%^^^%%%)))%%))))))))))))rr
)))))))))))))))%%%)))))%%^^^%)))))))))%^^^^^^%%%%)))))))))))))rr
)))))))))))))))%%))))))%^^^^%)))))))))%%^^^^^^^^%)))))))))))))rr
))))))))))))))))))))))))%%^^%)))))))))))%%%%^^^%))))))))))))))rr
))))))))))))))))))))))))))%^%)))))))))))))))%%%)))))))))))))))rr
))))))))))))))))))))))))))%^^%))))%%))))))))))))))))))))))))))rr
)))))))))))))))))))$))))))%^^%)))%^^%)))))))))))))%%))))))))))rr
))))))))))))))))))%%))))))%^^^%)%^^%%))))))))))))%%%))))))))))rr
))))))))))))))))))%%)))))))%^^^%^^%))))))))))))))$))))))))))))rr
)))))))))))))))))))))))))))%^^^^^%))))))))))))))))))))))))))))rr
)))))))))))))))))))))))))))%%^^^%)))))))))))))))))))))))))))))rr
)))))))))))))))))))))))))))))%%%))))))))))))))))))))))))))))))rr
))))))))))))))))))))))))))))))))))))))))))))))))))))))))))))))rr
))))))))))))))))))))))))))))))))))))))))))))))))))))))))))))))rr
))))))))))))))))))))))))))))))))))%%%)))))%%%)))))))))))))))))rr
))))))))))))))))))))))$)))))))))))%^^%)))%^%%)))))))))))))))))rr
))))))))))))))))))))))%%)))))))))%^^^^%%%^%)))))))))))))))))))rr
)))))))))))))))%%)))))%^%))))))))%^^^^^^^%))))))))))))))))))))rr
))%%%%%%))))))%^%)))))%^%)))))))%^^^^^^^%)))))))))))))))))))))rr
)%%%)))))))))%^^%))))))%%))))))%^^^^^^^%))))))))))))))))))))))rr
)$))))))))))%^^^^%)))))))))))%%^^^RR^^%))))))%%%))))))))))))))rr
)))))))))))%^^^^^%)))))))))))%^^^RrR^^%))))))%^^%%%)))))))))))rr
)))))))))))%^^^^^%)))))))))))%^^^RRR^^%))))))%^^^^^%%%%%))))))rr
))))))))))%^^^^^^%)))))))))))%^^^^^^^^%))))))%^^^^^^^^^%))))))rr
)))))))))%^^^^^^^%)))))))))))%^^^^%%%^^%)))))%^^^^^^^^^%))))))rr
)))))))%%^^^^^^^^^%%)))))))%%^^^^%)))%^%))))))%^^^^^^^^^%)))))rr
)))))))%^^^^^^^^^^^^%))))))%%^^^%)))))%%))))))%^^^%%%%^^%)))))rr
))))))))%%%%^^^^^^^%)))))))))%%%)))))))))))))))%%%))))%%))))))rr
%)))))))))))%^^^^^^%))))))))))))))))))))))))))))))))))))))))))rr
^%##)))))))))%^^^%%))))))))))))))))))))))))$)))))))))))))))%%%rr
^%%%))))))))))%%%)))))))))))))))))))))))))$%%))))))))))))))%%%rr
%)))))))))))))))))))))))))))))))))))))))))))))))))))))))))))))rr
))))))))))))))))))))))))))))))))))))))))))))))))))))))))))))))rr
rrrrrrrrrrrrrrrrrrrrrrrrrrrrrrrrrrrrrrrrrrrrrrrrrrrrrrrrrrrrrrrr
rrrrrrrrrrrrrrrrrrrrrrrrrrrrrrrrrrrrrrrrrrrrrrrrrrrrrrrrrrrrrrrr
