)))))))))))))))))%^^^^%))))))))%^^^^^^^^^%))))))))))))))))))))rr
)))))))))--+++)))%^^^^^%))))))))%^^^^^^^%-))))))))))))))))))))rr
)))))))))--+++)%%^^R^^^%)))))))))%%^^^^^%-))))))))))))))))))))rr
))))))))))----)%^^^^^^^%)))))))))))%^^^%---)))))))))))))))))))rr
)))))))))))--+)-%%%%^^^%)))))))))---%^^%-+-)))))))))))))))))-)rr
))))))))))))-+)-----%%^^%)))))))--+-%^^%---)))))))))))))))))--rr
))))-)-)))))-+)---+-))%^^%%%%)))-++--%^%))))-)))))))))))))))))rr
)))))-)-))))--)+-+--)))%^^^^^%)--+++-%^%))))))))))))))))))))))rr
)))))))))))))-)---+--))%^^^^^%-------%^%)))))))))))%%)))))))))rr
)))))))))))))))-)----)%^^^^^^^%--%%%%^^%)))---)))))%^%))))))))rr
)))))))))))------)-%%%^^^^^^^^^%%^^^^^^%)))-+----))%^%))))))))rr
)))))))))))-++++-)%^^^^^^^^^^^^^^^^^^^^%)))----+-))%%)))))))))rr
)))))))))))-++---%^^^R^^^^^^^^%%%^^^^^^%))))))---)%%))))))))))rr
)))))))))))--+--%^^^^^^^^^^^^%)))%^^^^^%)))))))))%^%))))))))))rr
-----))))))----%^^^^^^^^^^^^%))))%^(^(^())))))))%^^%))))))))--rr
+--+-)-))))----%^^^^^^^^^(^%)))))%^^(^^%)))))))%^^^%)))))))--+rr
++-+---)))--+--%%%%%%^^^^^^%)))))%^^^^^%)))----%^^%%)))))))-+-rr
+++-++-)))----)))))))%%%%%^^%))))%^^^^^%))--++-)%%))))))))--++rr
-+++++-)))))-))))-----))))%^%))))%%^^^^%)))--+---)))))))))-+++rr
--+--+-))))))))))-+-+--))%^^%))))))%%^^%)))--+-+-)))))))))----rr
)------))---)))))-+-++-))%^^%))))))))%^%)))---+--))))))))))))-rr
%%%%)$)))-+-)))))-++-+-)%^^^^%)))%%%%^^%)))-++--))))))))))))))rr
^^%)$^%%%-----)))---+--)%^^^^^%%%^^^^^^%)))----)))))))))))))))rr
%%)))%%^%%---%%%%%%---)%^^^^^^^^^^^^^^^^%%%%%%%%))))))))))))))rr
)))))))$))-%%^^^^^^%%%%^^^^^^^^^^^^^^^^^^^^^^^^%))))))))))))))rr
)))$)))))))%^^^^^^^^^^^^^^^^^^^^^^^^^^^^^^^^^^^^%))))))))%%)))rr
))%^%)))))%^^^^^^^^^^^^^^^^^^^^^^%%%%^^^^^%%^^^^%)))))))%^^%))rr
))%^%)))))%^^^^^%%%^^^^^^^^^%%%%%)))-%%%%%))%^^^%))))))$%%^%))rr
)%^^^%)))%^^^%%%)))%^^^^^^^%)--------))))))))%%%%)))))))))%%))rr
)%^^^%)))%%%%--)))))%^^^^^^%--+++++-)))))))))))))))))))))))%%)rr
))%^^%))))))---))))))%^^^^^%-+++++--))))))))))))))%%%))))))%%)rr
))%^^^%)))))---))))))%^^^^^%--+++--))))))))))))))%^^^%))))%^%)rr
))%^^^%)))))))))))))))%^^^%-------))))))))))))))%^^^^%))))%^%)rr
)%^^^^^%)))))))))))))--%%%----)))))$)))))))))))%^^^^^^%%%%^^^%rr
%^%%%%^^%%%%)))))))))------++-))))%%))))))))))%^^^^^^^^^^^^^^^rr
^%))))%%%%%^%%)))))))-+++++++-))))%%))))))))))%^^^^^^^^^^^^^^^rr
^%)))))))))%^^%)))))-----++-+-))%%^%))))))))))%^^^^^^^^^^^%%^^rr
^%))))))))))%^^%)))))--$------%%^^^^%)))))))))%^^^^^^^^%%%))%^rr
%))))))))))))%^^%%%%%%%^%--+-$^^^^^^^%))))))))%^^^^^^^%))))))%rr
%)))))))))))))%^^^^^^^^^%)----%^^^^^^^%)))))))%^^^^^^%))))))))rr
)))))))---)))))%%^^^^^%%)---+-%%%%^^^^^%))))))%^^^^^^%))))))))rr
)))))))-+--))))))%^^^%)))--++---))%^^^^^%%)---)%^^^^%)))))))))rr
)))))))----)))-)))%^%)))))------)))%^^^^^^%%))))%^^^%)))))))))rr
)))))))--+-))-)))))%%)))))%%%)))))%^^^^^^^^%)))))%^%))))))))))rr
))))))--++-)))-))-)%^%)))%^^^%)))%^^^^^^^^%%))))))%^%)))))))))rr
))))))-+++-))----))%^^%%%^^^^^%%%^^^^^^^^%)))))))))%^%))))))))rr
))))))--------++--)%^^^^^^^^^^^^^^^^^^^^%-----)))))%^^%)))))))rr
)))))%%%-))-++----%^^^^^^^%^^^^R^^^^^^%%----+-)))))%^^^%))))))rr
)))))%^%)))----))%^^^%%%%%)%^^RrR^^^%%-----++-)))))%^^^%))))))rr
)$)))%^^%)))))))%^^^%)))))))%^^R^^^%-)-++++++-)))))%^^^%))))))rr
)))))%^^^%)%%%%%^^^^%)))))))%^^R^^%)))-++++---)))))%^^^^%)))))rr
))----%^^^%^^^^^^^^^%))))))))%^^^%))))---+++-))))))%%%%%))))))rr
)--++-%^^^%%%^^^^^^^%)))))))))%%%)-)))))-----))))))))))-)))))%rr
%--++-%^^%)))%^^^^^%%)))))))))))))))))))))))))))))))))))))))%^rr
^%-----%%)))))%^^%%))))))))))))))))))))$))))---)))))))-))))%^^rr
^^%%---))))))))%%)))))))))$%)))))))))--$-)))-+-$)-)))))))))%^^rr
^^^%--)))))))))))))))))))))$)))))))))------)-----)))))-)))))%^rr
^^#))))))))))))))))))))))))))))))))))-++++----++--)))))))))))%rr
^%))))))))))))))))))))))))))))))))))---+--+--+--+-))))))))))))rr
%)))))))))))))))))))))))))))))))))))))-++---------))))))))))))rr
))))))))))))))))))))))))))))))))))))))----))))))))))))))))))))rr
))))))))))))))))))))))))))))))))))))))-)))))))))))))))))))))))rr
rrrrrrrrrrrrrrrrrrrrrrrrrrrrrrrrrrrrrrrrrrrrrrrrrrrrrrrrrrrrrrrr
rrrrrrrrrrrrrrrrrrrrrrrrrrrrrrrrrrrrrrrrrrrrrrrrrrrrrrrrrrrrrrrr
