---%%))))))))%(%%))))))))))))))))))))))))-----)))))))))))))-+-rr
--(^%))))))))----)))))))))))))))))))))))-)))-))))))))))))))---rr
))(^%)))))))--++-)))))))))))---)-)))))))))-)-)))))))))))))))))rr
))%^%)))))))-+---)))))))))))-+-----)))))))))))))))))))))))))))rr
))%^())))))--+---)))))))))))---+-+--))))))))))))))))))))))))))rr
)%^^())))))----+-))))))))))))---+---))))))))))))))))))))))))))rr
)%^^%))))))%%----)))))))))))))-++--%%)))))))))))))----))))))))rr
)%^^%)))))%^^%--))))))))))))))--+-%^%---))))))))))-++---))))))rr
)%^^%)))))%^^%--)))))))))))))))---%^^%----)))))))---+++-))))))rr
))%%%)))))%^%---)))))))))))))))))%^^^%-++-)))))))---+-+-))))))rr
))))))))))%^^%--)))))))))))))))))%^^^%-++-)))))))-++-++-))))))rr
)))))))))%^^^%---))))))))))))))))%^R^%----)))))))--+----))))))rr
)))))))))%^^^%))-)))))))))))))))%^^^^^%)))))))))))-+-)))------rr
)))))%%%%^^^^%))))))))))))))))%%^^^^^^^%))))))))))---)))-++++-rr
)))))%^^^^^%%))))))))))))))))%^^^^%%%^^^%)))))))))))))))---+--rr
)))))%^^^^%))------))))))))))%^^^%)))%^^%)))))))))))))))))---)rr
))))))%%%%)))---++-)))))))))))%%%)))))%%))))))))))))))))))))))rr
)))))))))))))--+++-)))))))))))))))))))))----))))))))))))))))))rr
)))))))))))))------))))))))))))))))))))--++--)))))))))))))))))rr
))))))))))))))----%%%)))))%%))))))%%%)))--++---)))%%%)))))%%%)rr
)))))))))))))))--%%%^%)))%^^%))))##^^%))-++-+--))%^^^%)))%^^%-rr
))))))))-)))))))-$--%^%%%^^^^%)))##%^^%%------%%%^^^^^%%%^^%%%rr
)))))----))))))------%^^^^%%%^%%%%))%^^^%%)))$^^^^^^^R^^^^%---rr
)))))-+--)))%%%%-++---%^^%)))%^^^%)))%^^%)))))%^^^^^^RRR^^%-++rr
)))))---%%%%^^^%-----))%%))))%^^%)))))%%%)))))%%^^^^RrrR^^%---rr
)%%%%%%%^^^^^^%)))))))))))))%^^^^%))))))))))))))%^^^RrrR^^^%%%rr
%^^^^^^^^^^^^^%))))))))))))%^^^^^%))))))))%%)))))%^RrrrR^^^^^^rr
^^^R^^^^^^^^^^%)))%%%)))))%^^^^^%%)))))))%^^%))))%^RRRR^^^^^^^rr
%^^^^^^%%^^^^^%))$^^^%)))%%%%%%%))))%%)%%^^^^%)))%^^^^^^^^^^^^rr
)%^^^%%))%%%%%))))%^^^%%%%)))))))))%^^%^^^^^^%))-%%%%%^^%%%%%%rr
))%^%)))))))))))))%^^^^^%))))))))))%^^^RRR^^^%))------%%))))))rr
))%^%)))))))))))))%^^^^%))))))))))%^(^RrrR^^^%))-++++-))))))))rr
))%%))))))))))))))%^%%%))))))))))%^^^^RrR^^^^^%)---++-))))))))rr
))%%)))))))))))))))$--))))))))%%%^^%^^RrR^^%^^^%%%----)$))))))rr
)%^%)))))))))))))))---))))))%%^^^^%)%^RRR^%)%^^^^^%--%%^%)))))rr
)%^^%)))))))))))))))))))))%%^^^R^%)))%^^^%)))%^^^^%-%^^^%)))))rr
))%^^%))))))))))))))$)))%%^^^^^^^%)))%^^%))))%^^^^^%^^^^^%))))rr
))%^^^%%)))))))))%%%^%%%^^^%%^^^^%))))%%%))))%^^^^^^^^^^^^%)))rr
)))%^^^^%%%)))%%%^^^^^^^^^%--%^^^^%)))))))%%%^^^^^^^^^^^^^^%))rr
))%^^^^^^^%%%%^^^^^^^^^^^%----%^^^^%%))))%^^^^^^^^^^^^R^^^^%))rr
)%^^%%%%%%)%%^^^^^^^^^^^^%-+--%^^^^^^%)%%^^^^^^^^^^^^^^^^^%%%)rr
%^^%)))))))))%%%%%%%%%%%%)---%^^^^^^^^%^^^^RR^^^^^^^^^^%%%)))$rr
^^^%)))))))))))))))----))))%%^^^^^^^^^^^^^RrrR^^^^^^^^%---))))rr
^^^^%))))))))))))))----))%%^^^^^^^^^^^^^^RrR^^^^^^^%%----))))rr
^^(^^%)))))))))))))))))%%^^^^^^^^^^^^^^^^^RR^^%%%%%%))))))))))rr
^^^^^^%%%%)))))$)))))%%^^^^^^^^^^^^^^^^^^^^^^%-)))))))))))))$)rr
^^^RRRR^^%))))$^%))))%^^^^^^^^^^^^^%^^^^^^^^%--)-)))))))))%%^%rr
^^^RrrrR^%)))))$)))))%^^R^^^^^^^^%%)%^^^^^^%---)))))))))))%^^^rr
^^^RRRRR%))))))))))))%^^^^^%%%%%%))))%^^^%%--+-))-)))))))%^^^^rr
^^^^^^^^%))))))))))))%^^^^%)))))))))))%%%---++-))))))%%%%^RR^^rr
%^%^^^^^%))))))))))%%^^^%%))))))))))))))--+-++-))))%%^^^^RrR^^rr
)$)%%^^^%)))-----))%%^^%)))))))))))))))))---+--)))%^^^^RRrrrR^rr
)))))%^^%)))-+++--$%)%%)))))))))))))))))))-+--)))%%%^^^RRrrrR^rr
%%)))%^^%)))-----$---)))))))))))))-)))))))---))%%%))%^^^^RRR^^rr
^%--)%^^%))))--%%)-+--))))))))))))))))))))))))$%%))))%^^^^^^^^rr
%---))%^%)))))%^%--++-)))))))))))))$))))))))))))))))))%^^^^^^^rr
----))%%))))))%%)-+++-))))))))-)---%%))))))))))))))))))%^^^^^^rr
--%%%)))))))))%%)--+---))))))))--+--)))))))))))))))))))-%%%%%%rr
-%^^^%)))))))%^%))---)))))))))))-++-)))))))))))))))))))-------rr
-%^^^%)))))))%%%))))))))---))))---+-)))))))))))))))))))-+-+++-rr
-%%^%%-))))))))))))))))--+-))))))---))-)))))))))))))))--+++++-rr
---$--))))))))))))))))))----))))))))))))))))))))))))))-+++++--rr
rrrrrrrrrrrrrrrrrrrrrrrrrrrrrrrrrrrrrrrrrrrrrrrrrrrrrrrrrrrrrrrr
rrrrrrrrrrrrrrrrrrrrrrrrrrrrrrrrrrrrrrrrrrrrrrrrrrrrrrrrrrrrrrrr
