))))))))))))hhhhhhh)-------))))^^)))))))))^^^^^^^^)))))))))))))
))))))))))))))))))))-------)))))))))))))))^^^^^^)))))))))))))))
^^^^^^^^))))))))))))-------))))))))))))))^^^^^^))))))))))))))))
^^^^^^^^^^^^^)))))^^)-----)))))))))))))))^^^^^)))))))))))))))))
^^^^^^^^^^^^^^)))^^^))-)))^^^)))))))))))^^^^^^)))))))))))))))))
))^^^^^^^))^^^^^^^))))))))^^^)))))))))^^^^^^)))-----)))))))))))
))^^^^)))))))^^^^^)))))))))))))))))))^^^^^)))))-----)-))))---))
))^^^))))))))^^^^))))))))))))))))))))^^^^))))))------))))----))
)^^^^)))))))))^^^)))h)))))))^^)))))))^^^^)))))))-----))))----))
)^^^^)))))))))^^^))))))))))^^^^^^^^^^^^^^)))))))---^^^^^^^^-)))
)^^^^)))))))))^^^))))))))))^^^^^^^^^^^^^^))))))^^^^^^^^^^^^^^))
))^^^)))))))))^^^)))))))))^^^^^^^^^^^^^^^)))))^^^^^^^^^^^^^^^))
)))^^)))))))))^^^^)))))))^^^^^^^^^^^^^^^^)))))^^^^^^^^^^^^^^^))
))))))))))))))^^^^)))^^^^^^^^^^^^^)))^^^^)))))^^^^^^^^^^^^^))))
))))))))))))))^^^^)))^^^^^^^^^^^^)))))^^^^^^^^^^^^^^^^^^^^)))))
)))))))))))))^^^^^)))^^^^^^^^^^^^)))))^^^^^^^^^^^^^^^^^^^))))))
)))))))))))))^^^^^^))^^^^^^^^^^^^))))))^^^^^^^^^^^^^^^^^^))))))
)))))))^)))))^^^^^^^))^^^^^^^^^^^))))))^^^^^^^^^^^^^^^^^^^)))))
))))))^^^))))^^^^^^^^)))))))^^^^^^))))))^^^^^^^^^^^^RRR^^^)))))
)))))^^^^)))))^^^^^^^^)))))))^^^^^^^^)))^^^^^^^^^^^^^^^^^))))))
)))))^^^^)))))^^^^^^^^^)))))))^^^^^^)^)^^^^^^^^^^^^^^^^^^))))))
)))))^^^^))))))^^^^^^^^^))))))^^^)))))))^^^^^^)))^^)))^----))))
)))))^^^^^^)))))^^^^^^^^))))))))))))))))^^^^^^))))))))-----))))
)))))^^^^^^^^))))^^^^^^^))))))))))))))))^^^^^^))))))))-----))))
^^)))^^^^^^^^^)))^^^^^^^)))))))))))))))^^^^^^^))))))))-----))))
^^)))^^^^^^^^^^)^^^^^^^^^)))))))))))))^^^^^^^^))))))))-^^^)))^^
^^)))^^^^^^^^^^^^^^^^^^^^^^^^)))))^^^^^^^^^^^^)))))^^^^^^^)))^^
^^^))^^^^^^^^^)^^^^^^^^^^^^^^^)))^^^^^^^^^^^^^)))^^^^^^^^^))))^
^^^^^^^^^^^^))))^^^^^^^^^^^^^^)))^^^^^^^^^^^^^))^^^^^^R^^)))))^
^^^^^^^^^^^^))))---^^^^^^^^^^^--)^^^^^))))^^^^^^^^^^^^^^^)))^^^
^^^^^^RRR^^^^)))---))^^^^^^))-----))))))))^^^^^^^^^))^^^^^^^^^^
^^^^^^RRR^^^^--------)^^^^))------))))))))^^^^^^^^)))^^^^^^^^^^
^^^^^^RR^^^^^--------)^^^))))-----))))))))^^^^^^^)))))^^^^RR^^^
^^^^^^^^^^^^---------)^^^^^))----)))))))))^^^^^^^))))^^^^^^^^^^
^^^^^^^^^^)--------)))^^^^^^^^^^^)))))))))^^^^^^^^^^^^^^^^^^^^^
))))^^^^^^)----))-h)))^^^^^^^^^^^)^^)))))))^^^^^^^^^^^^^^^^^^^^
----^^^^^^)---))))))))^^^^^^^^^^))^^))))))))^^^^^^^^^^^^^^^^^^^
----)^^^^^^^^^))))))))^^RR^^^^)))))))))))))))^^^^^^^^^^^^^^^)))
----)^^R^^^^^^^^^))))^^^RR^^^^))))))))))))))))^^^^^^^^^^^^^))))
----)^^RR^^^^^^^^)))))^^^^^^^^)))))^))))))))))^^^^^))^^^^^)))))
---)))^^^^^^^^^^))))))^^^^^^^^)))))^^^))))))))^^^^^))))^)))))))
---)))^^^^^)))))))))))))))))^^^^^^)))^^^))))))^^^^^))))))))))))
)))))^^^^))))))))))))))))))))^^^^))))^^^^^^^^^^^^^^)-))))))))))
))^^^^^^))))))))))))))))))h)))^^^)))))^^^^^^^^^^^^^--))))))^)))
))^^^^^^))))h))))))))))))hhh)))))))h))^^^^^^^^^^^^---))))))^^))
))^^^^^^))))h)))---))))))))))))))))h)))^^^))))^^^----))))))^^))
)))^^^^^))))h)))----)))))))))))))))))))^^))))))))----))))))^^))
)))))^^^)))hhh------)))))))))))))))))))))))))))))--))))))))^^))
))))))^))))hhh------)))))))))^^)))))))))))hhh))))))hhhh))))^^^)
^^)))))))))hhh------)))))))))^^)))))))))))hhhh)))))))hh))))^^^^
^))))))))))hhhhh--------)))h)))))))))))))hhhhhhhh)))))hh)))^^^^
))))))))))))hhhh-------)))hhh))))))))))))))hhhhhh)))))))))^^^^^
)))))))))))))hhhhhh-----))hh)))))))))hhhhhh)hhhh))))))))))^^^^^
))))))))))))))hhhhh-----)))))))))))))hhhhhhh)hhh)))))))))^^))^^
)))^)))))))))))hhhh-----)))))))^)))))hhhhhhhh)h))))))))^^^))))^
)^^^^^)))^^^)))hhhhh-)))))))))^^^))))hhhhhhhhh))))))))^^^))))))
)))^^^^^^^^^)))hhhhhh)))))))))^^^)))))hhhhhhhhhhh)))))^^^))))))
)))))^^^^^)))))hhhhhh))))))))^^^^))))hhhhhhhhhhhh)))))^^^))))))
))))))^^^))))))hhhhhh))))))))^^^^^)))hhhhhhhhhhhh)))^^^^^^^^)))
))hh)))^))))hhhhhhhh-----)))))^^^)))hhhhhhhhhhhh)))^^^^^^^^^)))
)hhhh))))))hhhhhhh-------))))))^))))hhhhhhhhhhhh)))))))))))))))
)hhhhh))))hhhhhhhhh------)))))))))hhhhhhhhhhhhhh)))))))))))))))
hhhhhhh)hhhhhhhhhhh-----hhhhhh)))hhhhhhhhhhhhhhh)))))))))))))))
