))%(^(%))))))))))%(^^%)))%^^^^^^%))))))-)%(((((%))))))%%%((((%rr
)((^()))))))%%))%(^(^^%%(^^((((%)))))))))$)---)))))))-))))))%%rr
)((^%))))))%^^%%^^^^^(^^^^^^^^^%))%%%)))))--+-------)-----))))rr
)(^^%))))))%^^^(^^%%%%%^%%%^^^%)%%^^(%%)))--+--+++--)-++--))))rr
))%%)))))))%^(^^^%)))))$)))%^^^%^^%(%(^%)))-++++++----+-+-))))rr
)))$)))))))%((^^%))))))))))%^^^(^%---%^%)))-----+++-)-----))))rr
)))))))))))%^^^%)))))))))))%^^^^%-----%%)))))---+---)-%%))))))rr
)))))))))))%^%%))))))))))))%^^^^%---+-)$))))))-+--))))%())))))rr
)))))))))))%%--))))))))))))%^^^%)))------)))))---)))))))))))))rr
)))))))))))$----)))))))))))%^^^^%))))--+---)))))))))))))))))))rr
))-)))))))---++--))))))))))%^^^^^%)))-+++--))))))------)))))))rr
-))))-))))-+++-+-)%%)))))))%^^^^^^%%%--+--%%%))))-+--+-)))))))rr
---))----)--+++---%^%)))))%^^^^^^^^^^%---%^^^%)))-++++---)))))rr
++----++--)-------%^%))))-%^^^%%%^^^^^%%%^^^^^%))--+++++-)))))rr
+--)-++++--%%--++-%^%))---%^^%)))%^^^^^^^^^^^^^%%%---++--)))))rr
--)--++++-%^%)----%^%---+-%^%)))))%^^^^%%%%%^^^^^%))----))))))rr
))))-+-+--%^^%)--%^^%--+--%^%)))))%^%%%)))))%^^^^^%)))))-)))))rr
))))--+--%^^^^%%%^^^^%---%^^%)))))%%-))))))%^^^^^^^%))----))))rr
)))))---%%%%%^^^^^^^^%--)%^^%)))))-----))))%^^^^^^^^%--+--))))rr
))))))))$))))%^^^^^^^^%)%^^^%))))--+++-)))%^^^%^^^^^^%-+--%%%)rr
))))))))))))))%%%%^^^^^%^^^^^%))-------))%^^^%)%%^^RR%---%^^%)rr
))))))))))))))))))%^^^^^^^^^^%))-----%%%%^^^%))))%^RR^%%%^^^%)rr
)))))))))))))))))))%^^^^^^^^^^%)----)%^^^^^^%)-)-%^^R^^^^^^^%)rr
)))))))))))))))))))%^^^^^^^^^%%)-+--))%^^^^^%))))%^^^^^^^^^^%)rr
)))%%)))))))))))))))%^^^^^^^%)))-++-))%^^^^^%))---%%^^^^^^^^%)rr
)%%^^%%%%))))))))))))%^^^^^^%)))--+-))%^^^^^%)))----%^^R^^^^^%rr
%^^^^^^^^%)))))))))))%^^^^^^%))))-+-)))%^^^^%)))--+-)%^RRR^^^^rr
%%^^^^^^^%)))))))))))%^^^^^^%))))---))))%^^^%))))---))%^^^^^^^rr
))%^^^^^%)))))))))))))%^^^^^%)))))))))))%%^^%)))))))--%%^^^^^^rr
)))%^^%%)))))))))))))%^^^^^%))))))))))))))%%%)))))))))--%%^^^%rr
))%^^%)))))))))))%%%%^^^^^%)))))))))))))))))))))))))------%^%)rr
))%^%)))))))))))$^^^^^^^^%)))))))))$)))))))))))))))))-))))%^%)rr
))%%%))))))))))))%%^^^^^^%))))))))))))))))))))))))))))-)))%^%)rr
)))))))))))))))))))%%^^^%))))))))))))$%)))))))))))))))))))%^%)rr
))))))-----))))))))))%^^%)))))))))))))%%%)))))))))))))))))%^%)rr
))-)))-+---)))))))))))%%)))))))))))))))$))))))))))))))))))%^%)rr
)))))-----%%))))))))))))))))))))))))))))))))))))))))))))))%^^%rr
))))))--%%^%))))))))))))))))))))))))))))))))))))-----)))))%^^%rr
))%%%%%%^^^^%)))))))))))))))))))))))))))))))))))-+++-)))))%^^^rr
)$%^^^^^^^^^%)))))))))))%%%%%)))))))))))))))))---+++-)))))%^^^rr
)))%%%%%%%^^^%)))))))))%^^^^%)))))%%))))))))))-+++---))))%^^^^rr
))))))))))%^^^%%%%---%%^^^^^^%)))%%))))))))))--+-+--)))))%^^^%rr
))))))))))%^^^^^^%-+-%^^^^^^^^%%%%)))))))))))-+++-+-))))$^^^%)rr
))))))))))%^%^^^^%---%^^^^^^^^^^%))))))))))))--+++--)))))%%%))rr
)))))))))%^%)%%%%))))%^^^^^^^^%%))))))))))))))---+-))))))))%))rr
))))))))%^%))))))))))%^^^^^^^%)))))))))))))))))----))))))))%%)rr
))))))%%^%))----)))))%^^^^^^%))))))))))))))))))))))$)))))))%^%rr
$%%%%%^^%)))-++--))))%^^^^^^%))))))$)))))))))))))%%^%)))))%^^^rr
-%%%%^^^%)---++-)))))%^^^^^%)))))))))))))))))))))%^^^%))))%%%%rr
-----%^^%)))----))))))%^^%%))))))))))$%))))))))%%^RR^^%))%%)))rr
+--+-)%^%))))))))))))))%%)))))))))))))%%%%%%%%%^^^RrR^^%%%))))rr
--+--))%%))))))))))))))$)))-))))))))))%^^^^^^^^^^^RRR^^%))))))rr
)---)--$)---)))))))))))))))))))))))))))%^^^^^%%%%^^^^^%)))))))rr
)-)))-----+--))))))))))%%))))))--))))))%^^^^%))))%%%%%))))))))rr
)))))--+++---))))))%%%%^%-)))----))$)))%^^^^%)))))))))))))))))rr
))%%%----+++-))))$%^^^^^%))))-++-)%^%%%^^^RR^%)))---)))))))%%-rr
))%%^%)------))))))%%%^%)))))----$^^^^^^^^RR^%)))-+---)))%%^^%rr
))))%^%%%%%--)))))))))$))))))))---%^^^^^^^^^^^%%)--+-%%%%^^^%-rr
)))))%^^^^^%)))))))---)))---)))-)))%%^^^^^^^^^^^%%---%^^^^^%%-rr
))))))%%%%%%)))))---+-)---+--)-))))))%%%%%%%%%^^%%))-%^^^%%---rr
)))))))))))))))))-++--))-+----))))))))))))))))%%))))))%%%)--++rr
))))))))))))))))--++-)))--+++--)))))))))))))))))))))))))))-+-+rr
rrrrrrrrrrrrrrrrrrrrrrrrrrrrrrrrrrrrrrrrrrrrrrrrrrrrrrrrrrrrrrrr
rrrrrrrrrrrrrrrrrrrrrrrrrrrrrrrrrrrrrrrrrrrrrrrrrrrrrrrrrrrrrrrr
