)))))))))))%^(RR^())))%^^(^(^%)))$)%%^^(^((^^(^((^^%%)))))))))rr
))))))))))%^^^^^^%)))%^^^^^^^%)))))))%^^^^%%%%^^%%%)))))))))))rr
))))))))))%^^((^%))))%^RRRR^^%))))))))%^^%))))%%))))))))))))))rr
))))))))))%^^(^^%)))))%RRRR^^^%))))))))%%)))))))))))))))))))))rr
)))))))))))%%^^^%)))))%^^^^(^^%))))))))%%)))))))))))))))))))))rr
)))))))))))))%^^%))))))%^^^(^^^%))))))%^%)))))))))))))))))))))rr
))))))))))))))%%))))))))%^^(^^^^%)))))%^%)))))))))))))))))))))rr
))))))))))))))))))))))))%^((^^^^%)))))%^%))))))))))))))-)-))))rr
)))))))))))))))))))))))%^^^^^^(^%)))))%%%)))))))))))))--))))))rr
))))))))))))))))))))))%^^^^^^^^^%)))))))))))))))))))))))))))))rr
)))))))))))))))))))))%^^R^^^^^^^%))))))))))))))))))))))))-))))rr
)))))))))))))))))))))%^rR^^^^^^^%)))))))))))))))))))))))))))))rr
))))))))))))))))))))))%^R^^^^^^%))))))))))))))))))))))))))))))rr
)))))))%%%%%))))))))))%^^^^^^^^%))))))))))))))))))))))))))))))rr
))))))%^^^^^%)))))))))%^^^^^^^^%))))))))))))))))))))))))))))))rr
))))))%^RRRR^%)))))))))%%%^^^^^%))))))))))))))))))))))))))))))rr
))))))%%^^RrR^%)))))))))))%^^^^%))))))))))))))))))))))))))))))rr
))))))))%^^RR^^%)))))))))))%^^^%))))))%%%)))))))))))))))))))))rr
)))))))))%(RR^^^%%)))))))))%^^^^%%)%%%^^^%))))))))))))))))))))rr
)))$)))))%^^R^^^^%%)))))))%^^^^^^^%^^^^^%)))))))))))))))))))))rr
))%^%))))%^^^^%%%)%%))))))%^^^^^^^^%%%%%))))))))))))))))))))))rr
)%^^^%))%^%%%%)))))%%%)))%^%%^^^%%%)))))))))))%%%))))))$))))))rr
%^^^^^%%^%)))))))))%^^%%%%%))%%%)))))))))))))%^^^%))))%^%)))))rr
%^^^^^^^%)))))))))%^^^^%%))))))))))))))))))))%^^^%))))%^%)))))rr
)%%%^^^^%)))))))))%^^%%))))))))))))))))))))))%%%%))))))$))))))rr
))))%^^^%)))))))))%^%))))))))))))))))))))))$))))))))))))))))))rr
)))))%^^^%%%))))))%^%)))))))))))))))))))))%^%)))))))))))))))))rr
))))))%^^^^%))))))%^%))))))$)))))))))))))%^^%)))))))))))))))))rr
))))))%^^^^%))))))%^%)))))%^%))))))))))))%^^^%))))))))))))))))rr
))))))%^^^%)))))))%^%)))))%^%)))))))))))%^%%%%)))))$))))))))))rr
))))))%^^%))))))))%^%)))))%^%))))))))%%%^%)))%%%%%%^%%))))))))rr
%)))))%^%)))))))))%^%)))))%^%))))))%%^%%%)))))%^^^^^^^%))%%%%%rr
%)))))%%%)))))))))%^%))))%^^%)))))%^^%))))))))%^^^^^^^^%%^^^^^rr
^%%%%))))))))))))$^^^%))%^%%))))))%^%)))))))))%^^^%%%^^^^^^^^^rr
^^^^^%))))))))))))%^^^%%^%))))))))%^%)))))))))%^^%)))%^^^^^^^^rr
^^RR^%)))))))))))%^^^%^^%))))))))%^^%)))))))))%^%)))))%^^^%^^^rr
^^RrR^%))))))))%%^^^%)%%))))))))%^^^^%)))))))))$)))))))%%%)%^^rr
^^RRR^^%)))%%%%^^^^^%)))))))))%%^^^^^^%)))))))))))))))))))))%^rr
^^^^^^^^%%%^(^^^^^^^%)))))))))%^^^^^^^^%)))))))))))))))))))))%rr
^^^^^^^^^^RRRRRRRRR^^%))))))))%^^^^^^^^^%)))))))))))))))))))))rr
%%%^^^^^^RRRrrrrrR^^^%)))))))))%%%%%^^^^%)))))))))))))))))))))rr
)))%%^^^^R^^RRrrR^^^^^%)))))))))))))%^^^%)))))))))))))))))))))rr
)))))%^^^^^^^^RR^^^^^^^%)))))))))))))%^^^%)))))))))))%%%%)))))rr
))))))%^^^^^^^^^^^^^^^^%)))))))))))))%^^^^%))))))))))%^^^%))))rr
)))))))%%%^^^^^^^^^^^^^%))))))))))))))%^^^%)))))))))%^^^%)))))rr
))))))))))%^^^^^^^^^^^^%))))))))))))))%^^%)))))))$))%^^^%)))))rr
))))))))))%^^^^^^^^^^^^%))))))))))))))%^%)))))%%%%)))%^^%)))))rr
))))))))))%^^^^^^^^^^^%)))))))$%)))))))$))))))%^^%)))%^%))))))rr
))))))))))%%%%%^^^^^^%)))))))))$)))))))))))-)))%^%))))%%))))))rr
)))))))))))))))%%^^^%)))))))))))))))))))-----))%^%))))))))))))rr
)))))))))))))))))%^%))))))))))))))))))))-+++-))%^%))))))))))))rr
)))))))))))))))))%^%))))))))))))))))))))-+++-))%%))))))))))$)$rr
)))))))))))))))))%%%))))))))))))))))))))---+-))))))))))))$%)))rr
))))))))))))))))%%)))$))))))))))))))))))))---)))))))))))$)))))rr
)))))))))))))))%%))))%%%))))))))))))))))))))))))))))))))))))))rr
)))))))))))))))%%)))))%%)))))))))))))))))))%%)))))))))))))))))rr
)))))))))))))))%)))))))$))))))))))%%))))))$%^%%)))))))))))))))rr
)))))))))))))))$)))))))))))))))))%^^%)))))))%^^%))))))%)))))))rr
)))))))))))))))))))))))))))))))%%^^^%))))))))%^%))))))%)))))))rr
))))))))))))))))))))))))))$%%%%%%%%%%)))))))))%%)))))))$))))))rr
))))))))))))))))))))))))))))))))))))))))))))))))))))))))))))))rr
))))))))))))))))))))))))))))))))))))))))))))))))))))))))))))))rr
rrrrrrrrrrrrrrrrrrrrrrrrrrrrrrrrrrrrrrrrrrrrrrrrrrrrrrrrrrrrrrrr
rrrrrrrrrrrrrrrrrrrrrrrrrrrrrrrrrrrrrrrrrrrrrrrrrrrrrrrrrrrrrrrr
