))(^%)))---%%))))%^^^%))))%%)))))))))))))))))))---%^^%---)))))rr
))%^%)------%%)))%^^^^%%%%^^%%)))))))))))))))))-+-%^^%-+--))))rr
))%%^)-++++--%%%%^^^^^^^^^^^^^%%)))))))))))))---+-%^%)--+-))))rr
))%^%--++++--)%^^^^^^^^^^^RR^^^^%))))))))))))-+++--%%)--+--)))rr
)-)%%---+---)-%^^^^^^^^^^^^^^^%%)))))))))))))---++--%%-----)))rr
)))%^%----))))%^^^%%%^^^^^%%%%)))))))))))))))-++++--%^%%%--)))rr
--)%^^%%%%%%%%^^^%---%^^^%))))))---)))))-))))-+--+--%^^^^%))))rr
+-%^^^^^^^^^^%%%%-----^^%)))))---+--)))))-)))--+-----%^^^%))))rr
--%%^^^^^^^%%)))))))))%^%))))--++---)-----))))---)-+--%%%)))))rr
-)-)%^^^^^%)))))))-)))%^^%%))-----%%%----)))))))))-----)))))))rr
)))))%%^%%))))))))))))%^^^^%%%%%%%^^^%%--%%%%))))%%%))))))))))rr
)))))))$))))))))))))))%^^^^^^^^^^^^^^^^%%^^^^%))$^^^%))))))$%)rr
))))))))))))))))----))%^^^^^^^^^^^^^^%%))%^^^%)))%^^%)))))))))rr
))))))))))))))))-++-)%^^RR^^^^^^^^^^%)))))%^%)))))%^%)))))))))rr
))))))))))))%%%)--+-)%^RR(^^^^^^^^^^%)))))%^%)))))%^%))------)rr
)))))))))))%^^^%%-+--%^RR^^^^^^^^^^%))))))%^%)))))%^^%)-++-+-)rr
)))))))))%%^^^^^%---)%^R^^^^^^^^^^^^%))))))%%%)))%^^^%)--++--)rr
))))%%%%%^^^^^^^^%--%^^^^^^^^^^^^^^^%))))))))$))%^^%^^%%-+++-)rr
))%%^^^^^R^^^^^^^^%%^^^^^^^^^^^^^^^^^%)))))))))%^^%)%^^%--+--)rr
)%^^^^^RRR^^^^^^^^^^^^^^^^%%%%^^^^^^^%))------)%%%)))%^%)---))rr
%^^^^^^^^^^^^^^^^^^^^^^^^%))))%%%^^^^%))-++++-))))))))%%))))))rr
^^^^^^%%%%%^^^^^^^^^^^^^%))))))))%^^^^%)-++-+-))))))))%%))))))rr
^^^^^%)))))%^^^^^^%%%%^%))))))))))%^^^^%-+++--))))))))))))))))rr
^RR^^%))))))%^^^^%))))%%)))))-))))%^^^^%---+-)))))))))))))))))rr
^R^^^^%))))))%^^^%))))%))))))))))%^^^^^%)----)))))))))))))))))rr
RR^^^^^%%%))))%^^%))))%%))))))))%^^^^^^%)))%%%%%%%%%))))))))))rr
^^^^^^^^^%))))%^%-)))$^^%))))))%^^^R^^^^%%%^^^^^^^^^%)))))))-%rr
^^%%^^^^%))))))%%----)%^%)))))%^^^RR^^^^^^^^^^^^^^^^^%)))---%^rr
%%--%^^^%))))))---++-))$)))--%^^^^RR^^^%^^^^^^^RRRRR^%)))--$%^rr
)---%^^^%))))))--+++-)-))-)--%^^^^^^^^%)%^^^^^^^RrrrR^%%%%%--%rr
))--%^^^%)))))))--+--)))-----%^^^^^^^%)))%^^^^^^^RrrrR^^^%----rr
))---%^^%))))))))-+----))-++--%^^^^^^%))))%^^^^^^^RrrrR^^%-++-rr
-)----%%))))))))----)))))---+-)%%%^^^%)))-%%%%%%^^(RrrrR^%----rr
))-)))))----))))))))%%%%%%----))))%^^%))))$)))))%^^RrrrR^%)-+-rr
)))))))--++--))))))%^^^^^%))))))))%^^%)))))))))))%^RrrrR(^%-+-rr
)))))))-++++-))))))%^^^^^%))))))))%^^^%))))))))))%^RrrrR^^%---rr
)))))))--++--)))))$%%%%%%))))))))%^^^^^%)))))))))%^RrrRR^%))))rr
))))%%%)--++--))))))))))-))))%%%%^^%%^^^%%%%)))))%^^RR^^^%))))rr
%%%%^^^%%--++-))))))))))))))%^^^^^%--%^^^^^%))))))%^^^^^%)))))rr
^^^^^^^^^%-++-))))))))))))))%^^^^%---)%^^^^^%)))))%^^^^^%)))))rr
^^^^^^^^^%----)))))))))))))))%%%%----))%%%%%%)))))%^^^^%))))))rr
^^^^^^^^^^%%%%)))))))))))))))-------)))))))))))))))%^^^%))))))rr
^^^^^^^^^^^^^^%%%))))))))))))))))))))))))))))))---))%^^^%)))))rr
^^^^^^^^^^^^^^^^%))))))))))))--+---))))))))))))-+--))%^^^%))))rr
%^^^^%%%%%^^^^^^%)))))))))))--++-+-)))))))))))---+--))%%%%))))rr
)%^^%)))))%^^^^^%)))))))))))-++++--)))))))))-)---+--))))))))))rr
)%^%))))))%^^^^^^%%)))))))))--+-++-)))))))))---++--$))))))))))rr
))%%))))))%^^%%%%%^%)))))))))------)))))))---++---%^%)))))))))rr
)%^^%))))%^^%)))))%^%)))))))))))))))))))))-++++++-%^%)))))))))rr
%^^^^%%%%^^%)))))))$))))))))))))))---)))))-+-+--+--%))))))))))rr
^^^^^^^^^^%)))))))))))))))))))))))-+---)-)---+-----%))))))))))rr
^^%%%%^^%%))))))))))))---)))))))))))))))-------)))%^%)))))))))rr
^%))))%%))))))))))-----+-)))))))))----+++++-)))))%^^%)))))))))rr
%))))))))))))))))---++++-))))))))))-++--+---))))%^^^%)))))))))rr
)))))))))))%%%%%%%%-++---)-))))))))-------)))%%%^^^^%))))))%%)rr
%)))))---))%^^^^%%--+++-))))))))))))))))))%%%^^^^^^^%))))%%^^%rr
%))----+-)$^^%%%)-------))))))))))))))))))%^^^^^^^^%%%))%^^^^^rr
^%#)-++---)%%)))--+--))))))))))))))))))))))%^^^^^^%)))%((^^^^^rr
^^##-++-))))))))-++--)))))))))))))%%%)))))))%^^^^%))))^((^%%%^rr
^%%%-++-))))))))-+-+-)))))))))))))%(%))))))))%^^^%))))%%%%)))%rr
%))-----))))))))-----)))))))))))))%%%)))))))))%%%)))))))))))))rr
))))))))))))))))))))))))))))))))))))))))))))))))))))))))))))))rr
rrrrrrrrrrrrrrrrrrrrrrrrrrrrrrrrrrrrrrrrrrrrrrrrrrrrrrrrrrrrrrrr
rrrrrrrrrrrrrrrrrrrrrrrrrrrrrrrrrrrrrrrrrrrrrrrrrrrrrrrrrrrrrrrr
