)))))))%^^%%%%%%%))))%%^^^^(^%--)))))))))))))))))))))))%^^RrR^rr
)))))))%^%)))))--))))))%^^((^^%--)))))))))))))))))))))%^^^RR^^rr
))%%%%%^%))))))----)))))%^^^^^^%%%%)))))))))))%%%%%%%%((^^RR^^rr
))%^^^^^%))))))--+-))))))%^(^^(^^^^%))))))))))%^(^^^^^(((^RR^^rr
)$%^^(^%)))-)))----))$))%^^^^%%%%%%%%))))))))))%^^^^^^((^^^^^%rr
)))%%^(^%------))))))%%%^^^^%)))----)$))))))))))%%%%^^^^^^^^%-rr
)))))%^^%-+-++--))))))%^(^^^%))--++---$%))---)))))))%^^^^^%%--rr
))))))%^%--++-+-))))))%^^^^^%))(+++++-)%%)-+-))))))))%^^^%)--+rr
)))))))%%)--+---))))))%^(^^%)))---+---)%%)-+-)))))))))%%%))-+-rr
)))))))%%))---))))))))%^^^%))))))-++-)))))-+-))))))))))))))---rr
)))))))%%)))))$%%%%%%%^^^%)))))))-+--)))))---))))))$))))))))))rr
)))))))$)))))))%^^^^(^^^%))))))))---))))))))-)))))%^%)))))))%%rr
%))))))))))))))%%^^^^^^%)))))))))))))))---)-)))))$^^%)))))))%^rr
^%%))))))))))))))%^^^^%))))))))))))))))$---)-)))))%^^%)--$--)%rr
^^^%%)))))%%)))))%^(^%)))))))))%%%%%%%%^%---)))))))%^^%%%%--)%rr
^^^^^%)))%^^%)))))%^^%)))))))))%^^^^^(^%---))))---))%%%%%---))rr
^%%%%^%%%^^^%))))))%^%)))))))))%^^^^^%%----)))--+-))))------))rr
%----%^^^^%%))))))))%^%%))))))))%^^^%)----)))--++-))))-+---)))rr
))-+--%^%%)))))))))))%^^%%%%)))))%^%)))))))))-+---)$))----%%%%rr
))-----$))))))))))))))%^^^^^%)))))%%)))))))))---))%^%)))))%^^^rr
))---+-)))))))))))))))%^^%%%))))))))))))))))))))-%%%%))))%^^^^rr
))))----)))))))))))))))%%)))))))))))))))))))))))%%-))$))%^%%%%rr
))))--+-)))))))))))))-))))))))))))))))))))))%%%%%---))$%^%))--rr
))---++--)))))))))))-------))))))))))))))%%%^^^^%--))))%%)---+rr
)))-+++-)))))))))))--+++-+--))))))))))))%^^^^^^^%--))))))))---rr
)))--+--))))))))))))--++++-))))---)))))%^^^^^^^^%-)))))))))-$-rr
))))---)))))))))))))----+--)))--+-)))))%^^^^^^^^^%%%))))))%%^%rr
)))-)))))))))))))))))-+---))))-+--))))$^^^%%%^^^^^^^%))))%^^^^rr
)))))))))))))))))))))---))))))--+--))))%^%)))%%%^^^^^%)))%^^^^rr
))))))))))))))))))))))))))))))--+--))))%%)))))))%%%%^%))%^%%%%rr
)))))))))))))))))))))))))))-------))))))))))))))))))%%%%%%))))rr
))))))))))))))))))))))))))--+++-))))))))))))))))))))))))))))))rr
))))))))))))))))))))))))))-+----))))))))))))))))))))))))))))))rr
))))))))))))))))))))))))))--++-)))))))))))))))))))))))))))))))rr
)))))))))))))))$)))))))))))----)))))))))))))))))))))))))))))))rr
)))))-----))))))))))))))))))))))))))))))))))))))))))))))))))))rr
)))))-+++-))))))))))))))))))-)-)))))))))))))))))))))))))))))))rr
)))))--++-)))))))))))))))))))---)))))))))))))))))$))))))))))))rr
)))))--+--)))))))))))))))))-)--$-))))))))))))%%%%))))))))))))-rr
-)))))---))))))))))))))))))))-%^%))))))))))))%%%%)))))))))))))rr
--))))))))))))))))))))))))))-)%^%))))))))$))))))))))))))))))))rr
+--))-----))))))))))))))))))))%^%))))))%%%))))))))))))))))-)))rr
-+--)-+-+-))))))))))$))))))))%^^^%%%%%%^%)))))))))))))))))))))rr
-++----++-))))))))%%^%%%%%%%%^^^^^^^^^^^%)))))))))%%%)))))))))rr
-----++++-))))))))%^^^^^^^%%%^^^^^^^^^^^%)))))))))%^^%))))))))rr
))-)---+--))))))-%^^^^^^^%--)%^^^^^^^^^^%)))-)))))%^^^%))%%%))rr
))))))------))-%%^^^^^^^%----)%^^^^^^^^^%-))))))))%^^^^%%^^%))rr
)))))))))-+----%^^^^^^^^%-+-)))%^^^^^^^^^%%)))))))%^^^^^^^^%))rr
))%%%))))---)---%%^^^^^^%---)))%^^^^^^^^^^%))))))))%^^^^^^^^%)rr
)%^^^%))))))--+---%^^^^^%)))))%^^^^^^^^^^%))))))))))%%^^^^^^^%rr
$^%^^^%%))))-+-+--%^^^^^^%%%%%^^^^^^^^^^^%))))))))))))%^^^^^^^rr
)$)%%^^%))))------%^^^^^^^^^^^^^^^^^^^^^%))))))))))))))%^^^RR^rr
-----%%%))))))))-)%^^^^^^^^^^^^^%%%%%%%%))))))))))))))))%^^R^^rr
+++-----))))))----%^^^^^^^%%%%%%-))))))))))))))------))))%^^^^rr
+---++----))))-++-%^^^^^%%))))---)-)))))))))))))-+++-))))%^^^^rr
-++-+++++--)))--+-%^^^%%)))))----)))))))))))))))--+--)))))%^^%rr
----+---++-))))---%%%%)))))))))))))))))))))))))-)---))))))%^^%rr
--++---++----))--$--)))-))))))$)))))))))))))))))))))))))))%^^%rr
-+++--+----+-)----------))))$%^%%))))))))))%%)))))))))))))%^^%rr
-++++---))---)-+-+-++-+-)))))%%%%%%%))))))%^^%))))))))))))%^^%rr
-+++---)))))))--+++---+--)))))))))))))))))%%%%))))))))))))%%%-rr
--++-+-)))))-)-------+++-))))))))))))))))))))))))))))))))))-))rr
rrrrrrrrrrrrrrrrrrrrrrrrrrrrrrrrrrrrrrrrrrrrrrrrrrrrrrrrrrrrrrrr
rrrrrrrrrrrrrrrrrrrrrrrrrrrrrrrrrrrrrrrrrrrrrrrrrrrrrrrrrrrrrrrr
