)))%%)))))))))-%%^^^^%)))%^^^^^^%)))))))%(^^^%-)))))))))))))))rr
))%^%))))))))----%^^^^%%%^^^^^^^%))))))))%^^%---))))))))))))))rr
))%^%)))))))))-+-%^^^^^^^^^^^^^^%)))))))))%^%-+-))))))))))))))rr
))%^%))))))%%)---)%^^^^^^^^^^^^^%)))))))))%%%-+---))))))))))))rr
))%^%)))))%^%)))))%^^^^^^^^^^^^^%)))))))))$))--)))))))))))))))rr
))%^%)))))%%)))))))%^^^^^^^^^^^%)))))))))$))))))))))))))))))))rr
))%^%)))))%%)))))))%^^^^^^^^^^%))))))))$%)))))))))))))))))))))rr
)))%%)))))%%)))))))%^^^^^^^^^%))))))))))))))))))))))))))))))))rr
)))%%)))))%^%)))))$^^^^^^^^^%))))))))))))))))))))))))))))----)rr
)))))$)))%^^%))))))%^^^^^^^^%))))))))))))))))))))))))))))-+++)rr
))))))$%%^^%)))))))%^^^^^^^^%))))))))))))))))))))))))))))--+-)rr
))))-))(%%%%))))))))%^^^^^^^%))))))))))))))$))))))))))))))---)rr
))---)))))))))))))))-%^^^^%%%)))))))))))))))))))))))))))))-+-)rr
))-+------)))))))-----%%%%))))))))))))))))))))))))))))))))))))rr
))-++++-+-)$)))))-----))))))))))))))))))))))))))))))%%))))---+rr
))--++--+-%^%))))---%%)))))))))))))))))))))))))))))%^^%%))--++rr
)))-+-----%^%))))--%^^%)))))))))))))))))))))))))))%^(%)))))---rr
)))---))-%^^%)))))%^^^^%%)))))))))))))))))))))))))%%))))))))))rr
))))-))%%^^%))))))%^^^^^^%%%))))))))))))))))))))))%%))))))))))rr
)))))))%^^^^%)))))%^^^^^^^^%))))))))))))))))))))))%%))))))))))rr
))))))))%%^^%))))%^^^^^^^^^%))))))))---))))))))))))%%%))))))))rr
))))))))))%^%))))%%%%^RR^^%))))))))--+---)))))))))))%^%%%%))))rr
))))))))))%^^%)))))))%^R^^%))))))))-+-++-----))))))))%^^^%))))rr
))))))))))%^^%)))))))%^R^%)))))))))-------+--))))))))%^R^%))))rr
))))))))))%^%)))))))))%^^%)))))))))))))))-++--)))))))%^R^%----rr
))))))))))%^%)))))))))%^%)))))))))))))))--++--)))))))%^^^%--+-rr
))))))))))%^%))))))))%^^%)))))))))))))))-----))))))))%^^^%-++-rr
))))))))))%^%)))))))%^^^^%))))))))))))))--%%%)))))))))%^^%-++-rr
))))))))))%^%))))))%^^^^^%))))))))))))))))%^^%))---))))%%----+rr
)))))))))))%%)))))%^^^^^^%)))%%%%))))))))$)%%^%)----))))-)-)--rr
)))$)))))))))))))%^^^RRR^%)))%(^%))))))))))))%^%%-+--)))))))))rr
))%^%))))))))))))%^^^RrR^%)))%^^%)))))))$)))))%%%-+--)))))))))rr
))%^%))))))))))))%^^^RrR^%))))%(%))))))%%)))))))--++-)))))))))rr
))%^%)))))))))))))%^^^R^^%))))%^%)))))%^^%))))))-+-+-)))))))))rr
))%^%)))))%%%))))))%^^^^^%))))%^^%)%%%^^^^%)))))-+---)))))))))rr
))%^%))))%^^%))))))%^^^^^%))))%^^^%^^^^^^^%)))))---))---))))))rr
)))%^%)))%^^^%))))%^^^^^%))))%^^^^^%%^^^^%)))))))))$)-+--)))))rr
))))%^%%%^^^^^%))%^^^^^%)))))%^^^^%))%%%%))))))))))))--+--))))rr
)))))%^^^^^%%^^%%^^^^^%)))))))%^^%)))))))))))))))))))-+++-))))rr
))))))%^^^%))%%%%^^^^%)))))---%^%))))))))))))))))))))--+--))))rr
))))))%%%%)))))))%^^^%)))))-+--$))))))))))))))))))))))---))---rr
))))))))))))))))))%^%)))))--++--)))))))%%))))))))))))$)))))-+-rr
))))))))))))))))))%^%)))))-+--+-))))))%^^%%)))))))))))%%)))-++rr
))))))))))))))))))%^^%))))---+--))))-)%^^^^%%%%)))))))%%)))-++rr
))))))-))))))))))%^^^^%)))))---))))----%^^^^^^^%)))))))-----+-rr
)-)-)-)%%%%%)))))%^^^^^%%))))))))------)%^^^^^^^%))))))))-+---rr
)))---%^^^^%)$)%%^^^^^^(^%)))))))-------)%^^^^^^^%%))))))-+---rr
----+-%^^%%))%%^^^^^^^^^^%)))))%%%%%%-)))%^^^^^^^^^%))))--+-+-rr
-+-++--%%)))))%^^^^^^%%%%---)))%^^^^^%)))%^^^^^^%%%%%))-)--+--rr
-++----))))))))%%^^^%))---+--)%^^^^^^%)))%^^^^%%)))))$-)-$-++-rr
--+--))))))))))--%^%)))-++---)%^^^^^^%)))%^^^%))))))))%%%%-+++rr
)--+-))))))))))--%%%)))-+++-)-%^^^^^^^%))%^^%)))))))))%^^%-++-rr
))---)))))))))-----$-))-----)-%^^^^^^^^%%^^^%))))))))-%^^%--+-rr
))))))))))))))-+++---)))-))%%))%%%%%^^^^^^^^())-)))))%^^^^%-+-rr
))-)))))))))))-++++--))))))%%)))))))%^^^^^^^^%)))))%%^^^^^%---rr
---)))))))))))---+---))))(%^^%)))))))%^^^^^^^%))))%^^^^^^^%--+rr
---%%)))))))))))---$-))))%^^^^%)))))))%^^^^^^^%)%%^^^^^^^^%-++rr
+-%^^%%%%%%%%)))--%^%%)))%^^^^^%))))))%^^^^^^^^%^^%%%^^^^%))+-rr
+-%^^^^^^^^^^%)))%^^^^%%%^^^^^^^%%%%%%^^^^^^^^^^^%)))%^^^%))-+rr
--%^^^^^^^^^^%)))%^^^^%%%^^^^^^^%%%%%%%%%%%%%%%%%)))))%%%)))-+rr
+-%%%%%%%%%%%))))%%%%%)))%%%%%%%))))))))))))))))---)))))))))--rr
+---))))))))))))))))))))))))))))))))))))))))))))-+-)))))))))-+rr
rrrrrrrrrrrrrrrrrrrrrrrrrrrrrrrrrrrrrrrrrrrrrrrrrrrrrrrrrrrrrrrr
rrrrrrrrrrrrrrrrrrrrrrrrrrrrrrrrrrrrrrrrrrrrrrrrrrrrrrrrrrrrrrrr
