))))))%%^^^^^^^^^^^^^^^^^%)))))$))))))%%-))))))))%%%^^^R^^^^%)rr
))))))))%%^^^^^^^^^^^^^^^%))))))))%%)))-)-))))------%^^^^^^^%-rr
))))))))--%^^^^^^^^^^^^^%))---))))%^%)))-))))--++-+-)%^^^^^^%-rr
))))))))--%%^^^^^^^^^^^^%)--+--)))%^%)))))%%%--++++-))%%^^^^%-rr
)))%%%))----%^^^^^%%%%%%))-+-+--)%^^^%)))%^^%----++-))))%%^^%-rr
))%^^^%%%%---%^^(%))))))))--++--)%^^^^%%%^^^^%------))))))%^%-rr
))%^^^^^^%----%^%)))))))-))-+--)))%^^^^^^RR^^%))--%%))))))%^%)rr
)%^^^^^%%-----)$)))))))))))---)))))%%^^RRrR^^%)))%^^%)))))%^^%rr
%^^%%%%---+++-)))))))))))))))))))))))%^RRRR^^%)))%^^^%))))%^^^rr
^^%))----++++--)))))))))))))))))$))))%^^^^^^^%)))%^^^^%))%^^^^rr
^%)))--)------))))))))))))))%%%%%)))))%^^^^^^%)))%^^^^^%%^^^^^rr
^%))--))))%%%%))))))))))))%%^^^^%)))))%^^^^^^%))))%%^^^^^^^^^^rr
%)))))))))%^^^%))$))))))))%^(^^%)))))))%(%^^^%))))))%^^^^^^^^^rr
)))))))))%%%%^^%%^%)))))))%^^^^()-))))))))%%%^%))))))%^^^^^^^^rr
)))))))%%%)))%^^^^%)))))))%^^^%))))))))))))))%%%--)))%^^^^^^^^rr
))))))$%%))---%^^%)))))))))%%%)-)-)))))))))))-----)))%^^^^^^^^rr
))))))))))--+-%%%%)))))))))))))))))))))))))))-----))))%^^%%%%^rr
)))))))))--+---)))))))-))))))))))))))))))))))))))))))))%%))))%rr
))--))))))---+-)))%%)-)))))))))))-))))))))))))))))))))))))))))rr
----))))-))-++-))%^^%----)))))))))))))))))))))))))))))))))))))rr
-++--)))-------)%^^%--++-)))))))))))))))))))))))))))))))))))))rr
++--)))----)%%%%^^%)-++--))%%%(%%%%)))%%))))))))))))))))))))))rr
+---))--+-%%^^^^^^(-----))%^^^^^^^^%%%^^%%)))%%%%%))))))))))))rr
+------+--%^RR^^^%--+--)))%^^RRRR^^^^^^^^^%%%^^^^^%%)))))-))))rr
-++-++-+-$^^^R^^^%-+--)))%^^^^^R^^^^^^^^^^%%%^^^^^^^%)))---)))rr
+-+++++---%%%^^^%--++-))%^^^^^^^^%%%%^^^^%)))%^^^^^^^%)--+---)rr
----++----)))%^^%-+++-)%^^%%%^^^%--))%^^^%))))%^(^^^^^%%--++-)rr
)))----)))))))%%--++--%^^%)))%^%---)-)%^%)))))%^^^^^^^^^%-+--)rr
)))))))))))))))))----)%^%))))%^%---)))%%))))))%^^^^^^^^^%---))rr
)))))))))))--))))))))))%%))%%^^^%)))))))))))))%^^^^^^^^^^%))))rr
)))))))-------))))))))))))%^^^^^^%)))))))))))%^RR^^^^^^^^^%%))rr
))))-)--+-+++-----))))))))%^^^^^^%)))))))))))%^R^^^^^^^^^^^^%%rr
)))-----+---+++++-))))))))%^^^^^^%)))))))))))%^^^^^^^^^^^^%%%^rr
)))--------++++-+-))))))))%^^^^^^^%)%%%%%)))))%^^^^^^^^^^%)))%rr
%)---%%(%%--++-+--))))))))%^^^^^^^^%^^^^%)))))%^^^^^^^^^%)))))rr
%----%(^(%-+-----)))))))))%^^^^^^^^^^^^^%)))))%^^^^^^^^^%)))))rr
------%%()---%%%))))))))))%^^^^R^^^^^^^^%)))))%^^^^^^^%%--))))rr
---%%----)-%%^^^%))))))))))%^^RrR^^^^^^^%)))))%^^^^^^%---)))))rr
))%^%--+-)%^(^^^%))))))))))%^^RrrR^^^^^^%))))%^^^^^^%)---)))))rr
)%^^^%---%^^^^^^%)))))))))))%^^RR^^^^^^%%%%%%^%^^^^^%)))))))))rr
)%^^^%)))%^^%%%%))))----)))))%^^^^^^^^%))%^^^%)%%%%%%%))))))))rr
%^^^^^%)%^%%---)))))-++--)))))%^^^^^^%))))%^%))))))))%%))%%%))rr
%^^R^^^%^%)----)))))--+--)))))%^^^^^^%))))%^%)))----))%%%^^^%%rr
)%^^^^^%%)))-+-)))))--++-))))))%^^^^^%))))%^%)))-++-))%^^^^^^^rr
)%^^^^%))))----))))%%----)))))))%%%%%%))))(%^%))--+-))%^^^^^%%rr
)%^^^%))))))))))))%^^%%%))---))))))))))---))%^%%%----%^^R^%%))rr
)%^^^%))))))))))))%(^^^^%%-+-))))))))))-+----%^^^%-+-%^R^%))))rr
)%^^%))))))))))))$^^^^^^%)---))))))))))-++++--%^^%---%^^^%))))rr
)%^^%)))))))))))))%^^^^^%)))-)-))))))))---+-+-%%%))))%^^%)))))rr
%^^^%))))))))))))))%%%%%))))))))))))-))-)--++---))))))%^%)))))rr
^^^^%)))))))))))))))))))))%%)))))))----))-+-+-+-))))))%%))))))rr
^^^^%))))))$))))))))))))))%^%))))))-++-))-+++---))))))))))))))rr
^^^^%)))))%^%)))))))))))))%^^%)))))--+-))-+)))))))))))))))))))rr
##^^%)))))%^^%)))))))))))))%%^%)))))---))--))))))))))))-)))))%rr
##^^%-----%^^%)))%%%)))))))))%^%%)))))))))))))))))))))-))))%%^rr
^^^^%-+-+-%^^^%%%^^^%))))))))%^^%))))))%%%%)))))))))))))))%^^^rr
^^^^%-+-+-%^^^^^^^(^^%))))))))%^%))))))%^(%)))))))))))))))%^^^rr
^^^^%--+--%^^^^^^^(^^^%%)%%))%^^%)))))%^^%))))))))))))))))))%^rr
^^^^^%---)%^^^^^^%%%%^^^%^^%%^^^%)))))%^%))))))))))))))))))))%rr
^^^^^%))))%^^^%%%))))%^^^^^%%^^%%))))))$))))))))))))))))))))))rr
%%%%%%))))%%%%))))))))%%%%%))%%)))))))))))))))))))))))))))))))rr
))))))))))))))))))))))))))))))))))))))))))))))))))))))))))))))rr
rrrrrrrrrrrrrrrrrrrrrrrrrrrrrrrrrrrrrrrrrrrrrrrrrrrrrrrrrrrrrrrr
rrrrrrrrrrrrrrrrrrrrrrrrrrrrrrrrrrrrrrrrrrrrrrrrrrrrrrrrrrrrrrrr
