))^^^^))----^^^^^^^^^^^^^^^^^))))))))))))hhhhhhhhhhhh))))))))))
))^^^^))-----^^^^^^^^^^^^^^^^^))))----))))hhhhhhhhhh)))))^)))))
)^^^^^))------)^^^^^^^^^^^^-^^^^^)----^)))hhhhhhhhhh)))^^^)))))
)^^^^^))------))))))^^^^^^---^^^^^----^^))hhhhhhhhhh)))^^))))))
)^^^^^^)---)))))))))^^^^^^---^^^^^------))hhhhhhhhhh)))))))))))
^^^^^^^^^^))))))))))^^^^^^^^^^^^^^^-----)hhhhhhhhh)))))))))))))
^^)))^^^^^^)))hhh)))^^^^^^^^^^^^^^^^----hh))))hhh---))hhhhh))))
)))))^^^^^^^)))h)))^^^^^^^^^^^^^^^^^)))hh)))))))------hhhhh))))
))))))^^^^^^^))))))^^^^^^^^^^^^^^^^^))))))-)))))-------hhhhh)))
))))))^^^^^^^^)))^^^^^^^^^^^^))))))))))))))))^))-^^----hhhhh)))
^)))))^^^^^^^^^^^^^^^^^^^^^^)))))))))))))))-^^^^^^^----hhhhh)))
))))))^^^^^^^^^^^^^^^^^^^^^^))))))))))))^^)-)^^^^^^---hhhhhh)))
-))---)^^^^^^^^^^^^^^^^^^^^^)))))))))))^^^)))-)))----))hhhhh)--
-------))^^^^^^)^^^^^^^^^^^^)))))))))))^^^^))))))----)))))))---
-------)))))))))^^^^^^^^^^^^))))))))^^^^^^)))----)))))))))-----
-------)))))))))))^^^^^^^^^^^)))))^^^^^^^^)------)))))))))-----
-----))))))))))))^^^^^^^^^^^)))))^^^^^^^^))------))))))))------
-^^^^)))))))))))^^^^^^^^^^)))))))^^^^^^^^))------))))))))------
^^^^^^^))))))))^^^^^^^^^^))))))))-))))))))^^^^-----))))))------
^^^^^^^^)))))))^^^^^^^^^^))))))----))))))^^^^^-------)))hh-----
^^^^^^^^))))))))^^^^^^^^^))))))----)))))^^^))--------)))))-----
^^^^^^^^)))))))))))))^^^^))))))----))))^^^))))))----))))))-))-)
^^)))^^^^^^)))))))))))^^^^^)))))))))))^^^)))))))----)))))))))^^
^))))))^^^^^)))))))))))^^^^^^^))))))))^^)))hh)))))))))))^^^^^^^
^))hh))))^^^^)))))))))))^^^^^^^)))))))))))hh)))))))))))----^^^^
^))hhh))))^^^^)))))))))))))))^^^))))))))))hh))))))^)))------)^^
)))hhhh)))^^^^^^^^^))))))))))))^)))))))))hhh)))^^^^^))--------^
)))hhhh)))^^^^^^^^^^))))))hh)))))))))))))))h)))^^^^^^)---------
))))h)))))^^^^^^^^^^^)))))hhh)))))))))))))))))))^^^^^^)--------
^))))))))^^^^^^^^^^^^-))))))hh))))))))))))))hh)-))^^^^)--------
^^)))))^^^)))^^^^^^^)-)))))))hhhh)))^^^^))))hhhh))^^^^)--------
^^^^^^^^^)))))^^^^^))-)-))))))hh)))^^^^^^))))h----^^^^^------))
^^^^^^^^^))))))^^)))^^))))))---)))^^^^^^^)))))-----^^^))))---))
^^^^^^^^^))))))))))^^^^^)))-----)^^^^^^^^)))))------))))))hhh))
^^^^^^^^^)))))))))^^^^^^^))-----)))))^^^^)))))------))))))hhh))
^^^^^^^^^^))))))))^^^^^^^))---^^^)^^))^^^)))))------)))---hhh--
^^^^^^^^^^^^)))))^^^^^^^^)))--^^^)^^))))))))))^---))h-----hh)--
^^^^^^^^^^^^^^^^^^^^^^^^^)))--^^^))))))))))))^^^^^)))-----h))--
^^^^^^^^^^^^^^^^^^^)^^^^^^))-^^^^^^^)))))))))^^^^^^^)-----)))-)
^^^^^^^^^^^^^^^^^^)))^^^^^^^^^^^^^^^^))))))))^^^^^^^^)---)))))^
^^^^^^^^^^^^^^^^)))))^^^^^^^^^^^^^^^^))))))))^^RR^^^^^---))))^^
^^^)^^^^^^^^----)))))^^^^^^^^^^^^^^^^))hh)))^^^^R^^^^^^^^^^^^^^
^^)))^^^^^^------)h))^^RR^^^^^^^^^^^^))hh))^^^^^R^^^^^^^^^^^^^^
^)))))^^^^--------hh))^^^^^^^^^^^^^^^))h))^^^^^^^^^^^^^^^^^^^^^
^)))))^^^^--------hhh))^^^^^^^^^^^^^^)))))^^^^^^^^^^^^^^^^^^^^^
)))))))^^^^^^-----))hh))))^^^^))^^^^^^)))^^^^^^^^^^^^^^^^^))^^^
))))))))^^^^^^^--))))hh)))^^^^)))^^R^^)))^^^^^^^^^))))))))))))^
^)))))))^^^^^^^^))))))hh))^^^^)))^^R^^^))^^^^^^^)))))))))))))))
^)----)^^^^^^^^^^^^))))h))^^^^^))^^^^^^))^^^^^^))))))))))))))))
^^----)^^^^^^^^^^^^^)))))))))^^))^^^^^^))^^^^^^^)))))))))))))))
^^----^^^^^^^^^^^^^^^)))))))))h)))^^^^^)))))^^^^^^^^^^^^^)))))^
^^----^^^^^^^^^^^^^^^))))))hhhhh))^^^^^)))))))^^^^^^^^^^^^)))^^
^^---)^^^^^^^^^^^^^^^^)))))---h)-))^^^^))))))))))))^^^^^^^^)^^^
^^---))^^^^^^^^^^^^^^^)))))----))))))^^^)))))))))))^^^^^^^^-^^^
^)))))-)^^^^^^--^^^^^^)))))---))))))))^^)))hhhhh)))^^^^^^^^-^^^
^)))))---^^^^^--^^^^^^))))^^^^^^^---))))))hhhhhh))))^^^^^^---^^
^)))))---^^^^^^^^^^^^^)))^^^^^^^^---))))))hhhhhh))))))^^^----^^
))))))----)))^^^^^^^^^^^^^^^^^^^^---))))))hhh)))))))))))------^
))))))----))))^^^^)))^^^^^^^^^^^^---))))))))))))))))))))-))---^
)))hh))---hh)))^^))))))^^^^^^^^^^----))))))))))))))))))))-hh)))
))hhhhh---hhh-))))))))))))))))))------))))))))))))))))))hhhhh))
)hhhhhhhhhhhhh)))-hhhh))))))))))------hhhhhhhhh)))))))hhhhhhhh)
hhhhhhhhhhhhhhhh-hhhhhh)))))))))h-----hhhhhhhhhhhhhhhhhhhhhhhhh
