)))))))))))))))))))))))))))))))))%^^^^%))))))))))))))))%^^^^^^rr
)))))%%))))))))))))))))))))))))))%^^^^%)))))-))-))))))%^^^^^^(rr
)))))%^%))))))))))))))))))))))))))%^^^^%%%%%%))))))))%^^^^^^^%rr
))))))%^%))))))))))))))))))))))))%^^^^^^^^^^^%--)))%%(^^^(^^%)rr
))))))%(%))))))))))%%))))))))))))%^^%%%%%^(^^^%))%%^^^^^^^^%)(rr
)))))%^^%))))))))))%())))))))))))%%%)))))%^^^^^%%^^^^^RR^^^%))rr
)))))(^^%----))))))%()))))))))))))))))))))%(^^(^^^^^^^RRR^%)))rr
))))%^((%-++--))))%((%)))))))))))))))))))))%^^^^(^^^(^^^^%%)))rr
))))%^^^%---+-))))%%%)))))))))%%))))))))))))%^^^^(^%%%%%%)))))rr
))))%^^^%-+---)))$))))))))))))%^%))))-)))))))%^^^^%)))))))))))rr
)))%^^^^%--+-))%%)))))))))))))%^%))))))-))))))%%^%%)))))))))))rr
)))%^^^^%--+-)%%))))))))))))))%^%))-----))))))))$)))))))))))))rr
)))%^^^^^%---)%%)))))))))))))))%%))--++--)))))))))))))))))))))rr
)))%^^^^^^%)))))))))))))))))))))))%%---+-))))))))))%%%))))))))rr
)))%^^^^^^^%%)))))))))))))%%%%)))%^^%)---))))))))))%^^%%%)))))rr
))%^^^^^^^^^%))))))))))))%^^^^%)%^^R^%)-))))))))))%^^^^^%)))))rr
))%^^^^^^^^%%))))))))))))%^^^^^%^^RrR^%)))))))))))%^^%%%))))))rr
))%^^^^^^^%))))))))))))))%^^^^^^^RrrR^%)))))))))))%^%)))))))))rr
))%^^^^^^%))))))))))))))))%^^^^RRrrrR^^%%%%%))))))%^%)))))%%%)rr
))%^^^^^%)))))))))))))))))%^^^^RRRRR^^^^^^^^%)))))%^^%))))%^%)rr
)))%%%%%))))))))))))))))))%^^^^^^^^^^^^^^^^^%)))))%^^%)))%^^%%rr
)))))))))))))))))))%%%)))%%%%^^^((%(%^^^^^^%%))))))%%%)))%%%))rr
)))))))))))))))))))%^^%%%%)))%^^^%)))%^^^^%))))))))))$))))))))rr
))))))))))%%%)))))%^^^^^^%)))%^^%))))%^^^^%)))))))))))))))))))rr
)))))))))%^^%)))))%^^^^^^%))))%%))))))%^^^%)))))))))))))))))))rr
))))))))%^^^^%)))%^^^^^^^%))))))))))))%^^^^%))))))))))))))))))rr
)))))))%^^^^^%)))%^^^^^^^^%)))))))))))%^^^^^%)))))))))))))))))rr
)))))))%^^^^^^%)%^^^^^^^^^^%%%%))))))))%^^^^%)))))))))))))))))rr
)))))))%^^^^^^^%^^^^^^^^^^^^^^^%)))))))%^^^^%)))))))))))))))))rr
))))))))%^^^^^^^^^^%^^^^^^^^^^^%))))))))%^^^%)))))))))))))))))rr
)))))))))%^^^^^^^^%)%^^^^^^^^^^^%%%))))))%^^%)))))))))))))))))rr
)))))))))%^^^^^^^%)))%^^^^^^^^^^^^^%%))))%^^%))))))))))))))%%)rr
))))))))))%^^^^^^%)))%^^^^^^^^^^^^^^^%)))%^%)))))))))))))%%^%)rr
))))))))))%^^^^^^^%%%^^^^^^^^^^^^^^^^^%%%^%%))))))))))))%^^^%)rr
)))))))))))%^^^^^^^^^^^^^^^^^^^^^^^%^^^^^%))))))))))))%%^^^^%)rr
)))))))))))%%^^^^^^^^^^^^^%%%%^^^%%)%%^^%)))))))))))))%^^^^^%-rr
)))))))))))))%%%%%%%^^^^^%))))%%%)))))%%)))))))))))))))%%%^^%-rr
))))))))))))))))))))%^^^^%))))))))))))))))))))))))))))))))%^^%rr
)%%%%))))))))))))))))%^^%)))))))))))))))))))))))))))))))))%^^^rr
)%^^^%))-----)))))))))%^%))))))))))))))))))))))))))))))))%^R^^rr
)%^^%%))-+-+-)))))-)))%^%))))))))))))))))))))))))))))))))%^R^^rr
))%%))))--++-))))))))%^^%)))))))))))))))))))))))))))))))%^^^^^rr
))))))))-+++-)))-)-%%^^^%)))))%%%%%%%%%%)))))))))))))))%^^^^^%rr
))))))))-----)))))%^^^^^%)))))%^^^^^^^^%)))))))))))))))%^^^^^%rr
))))))))))-)))))))%^^%%%)))))))%^^^^^^%)))))))))))))))))%%^^^%rr
))))))))))))))))))%^%)))))))))))%^^^^%))))))))))))))))))))%^^^rr
%%%%%)))))))))))))%^%))))))))))))%^^%)))))%%%)))))))))))))%^^^rr
^^^^^%))))))))))))%^%))))))))))))%^^%)))))%^%)))))%%%)))))%^^^rr
^^RR^%)))))))))))%^^%))))))))))))%^^^%)))%^R^%)))%^^^%)))%^^^^rr
^^^^^%)))))))))))%^^%))))))))))))%^^^^%)%^^R^^%%%^^^^^%%%^%%%^rr
^^^^%))))))))))%%^^^%)))))%%%))))%^^^^^%^^^^^^^^^^RR^^^^^%)))%rr
^^^^%))))))))%%^^^%%)))))%^^%))))%^^^^^^^^^^^^^^^^RRR^^^%)))))rr
^^^^%))))))))%%^%%)))))))%^^^%)))%^^^%%%%%%%%%%%^^^^^^^%))))))rr
^^^%^%)))%%%%))$)))))$)%%^^^^^%%%^^%%)))))))))))%%^^^^^%))))))rr
^^%)%^%%%^^^%))))))))%%^^^^^^^^^^^%)))))))))))))))%%%%%)))))))rr
^%)))%^^^^^^^%))))))))%%^^^^^^^^^%))))))))))))))))))))))))))))rr
%)))))%^^^^^^^%)))))))))%%%^^^^^%)))))))))))))))))))))))))))))rr
))))))%^^^^^^^^%%%%))))))))%^^^^%)))))))))))))))))%%()))))))))rr
))##%%)%%^^^^^^^^^^%))))))))%%^^%)))))))))))))))))%^()))))))))rr
))%%%%)))%%%%%%%%%%%))))))))))%%%)))))))))%%%))))$^^%)))))))))rr
))))))))))))))))))))))))))))))))))))))))))%%%)))))%%%)))))))))rr
))))))))))))))))))))))))))))))))))))))))))))))))))))))))))))))rr
rrrrrrrrrrrrrrrrrrrrrrrrrrrrrrrrrrrrrrrrrrrrrrrrrrrrrrrrrrrrrrrr
rrrrrrrrrrrrrrrrrrrrrrrrrrrrrrrrrrrrrrrrrrrrrrrrrrrrrrrrrrrrrrrr
