))-))))$))))))))))))))))))))%%%)))))))))))%^^^^^^^^^^%))%^RR^^rr
----))))))))))))))))))))---)%^^%%%))))))))%^^^(^^^^^^^%%^^R^^^rr
))-)))))%%%%))))))))-----+-)%^^^^^%%))))))%^^(^^^^^^^^^^^(^^^^rr
))))))))%((^%)))))))-+++---))%^^^^(^%))))%^^^^^^^(^(^^(^^(^^^^rr
%%)))))))%%%%)))))))---++--))%^^^^^^^%%)%^^^^((^^^%%^^^^^^^^^^rr
^%)))))))))))))))))))-++--)))%^^^^%%%^^%^^%%%^^^^%--%^^RR^^%%^rr
^%))))))))))))))))-)----+-))%^^^^%)))%^^^%)))%^^%----%^RR^%))%rr
(%)))))))))))))))-)-)))---)%^^(^%))))%^^^%))))%^%----%^^^%)))%rr
(%)))))))))))))))-%%%)))))%^^^^^%)))))%^%))))))$))----%%%))))%rr
^%))))))))))))))%%^^^%)))%^^^^(^^%))))%%%)))))))))-++----))))%rr
^%)))))))))))%%%^^^(^^%%%^^((^^^^^%%))))))%%%)))))----++-))))%rr
^%)-))))))%%%^^^^^RRR^^^^^^%^^^^^^^^%))))$^^^%))))%%%----))))%rr
%)-)--)))%^^^^^^^^RRR^^^^^%-%^^^^^^^%)))))%^^^%%%%^^^%--)))))%rr
)))%%%%%%^^^^^%%^^^^^^^^^%---%^^^^^%))))))%^^^^^^^^^^%--))))))rr
))%^^^^^^^^^^%))%^(^^^^^%--+-)%^^^^%))))))%^^^^^^^^^^^%-))))))rr
%%^^^^^^^^^^^^%-)%^^^^^%--++-)%^^^%)))))))%^^^^^^^%^^^^%))))))rr
^^^%%%%%%%%^^^^%%^%%%%%%)----)%^^^^%)))))%^^%%%%%%)%%^^%))))))rr
^^%))-)----%%^^^^%----))-)))))%^^^^^%%%%%^^%)))))---)%^^%)))))rr
^%)-----+----%^^%-----))))))%%^^^^^^^^^^^^%)))----+-))%^^%%%%%rr
%))-++++---+-)%^%---))))))%%^^^^^^^^^^^^^%))))--++--)))%^^^^^^rr
%))-+-+-+++--)%^%)))))))%%^%%%%%%%%%%%%%%))))--+++-)))))%%%%^^rr
%))---------))%^%))))))%^^%))))))))))))))))))-+++--)))))))))%^rr
%))))--%%%%%%%^^%))))))%^%)))))))))))))))))))-----)))))))))))%rr
%)))))%^^^^^^^^^%)))))$%%)))))))))))))))))))))))))))))))))))))rr
^%))))%^^^%%%%%%)))))))---))))))))))))))))))))))))))))))))))))rr
%))))))%%%)))))))))))))-+--)))))))))))))))))))))))))))--+-))))rr
%))))))))))))))))))))))---)))))))))%%%%%%%%))))))))))--+--))))rr
%))))))))))))))))))))))))))))))))))%^^^^^^^%)))))))$)-+++-))))rr
))))))))))))-))))))))))))))))))))))%^^^^^^^^%)))))$%)-+-+-))))rr
)))))----))-))---)))))))))))))))---)%^^^^^%%)))))))))------)))rr
))))--++-))----+-))))---))))))))-+--%^^^^%))))))))))))-+++-)))rr
)))--++--)--++++--))--+---)))))--++--%^^^%))))))))))))--++-)))rr
)))-+++-))-++-+++-)--+-++----)))-+++-%^^^%)))))))))))))----)))rr
)))-----))-++-----)-+-++---+--))-+----%^^%))))))))))))))))))))rr
))))))))))-+++-$)))----+-$-++--)------%^^%))))))))))))))))))))rr
))))))))))-+++-$)))))-+-----+-))))))))%^^^%))))))))))))%%)))))rr
)))))-)----++---)))))--+------))))))))%^^^^%)))))))))))%%)))-)rr
))))----+-+---))))))---+-)-%%%%)))))))%^^^^^%%))))-----%%)-)-)rr
)))---+--++-))))))))-+-+--)%^^^%%%)))%^^^^^^^^%%)--+++-$)))-))rr
)))-++++++--))))))))-++++--%^^^^^^%%%^^^^^^^^^^%)-+++--)))))))rr
)))---+-++-)))))))))---++-))%^^^^^^^^^^^^^^^^^^%)-++-+-)))))))rr
)))))-+----)))))))))))--+-)))%^^^^^^^^^^^^^^^%%))--+---)))))))rr
)))))---))))---))))))))---))))%^^^^^^^^^^^^^%))))----)))))))))rr
))))))))))))-+-))))$)))))))))))%^^^^^^^^^^^^%)))))%%))))))))))rr
)))))))))))--+--)))$))---))))))%^^%%%^^^^^^^^%%%%%^^%)))))))))rr
)))))))))))-+-+--))))--+-)))))%^^%)))%^^^^^^^^^^^^^^^%))))))))rr
)))))))))))--+++-))))-++-)))%%^^%)))))%^^^^^^^^^^^^^^^%%%))))-rr
))))))))))))-++--))))--+-))%^^^%))))))%^^^^^^^^^^^^^^^^%%)----rr
)))))))---))----)))----+-)%^^%%))))))))%^^^^^^^^^^^^^%%)))-+++rr
))))))--+-)))))------+---%^^%)))))))))%^^^^^^^(^^^^^%))))----+rr
))))))-+--)))))-+++----%%^^%))))))))))%^^^^^^^^^^^^^%)))))-$--rr
))))))---))))---++++-)-%^^^%))))))))))%^^^^^^^^^^^^^%))))))%%-rr
))))))---))))-++++++----%%^%)))))))))))%^^^^^^^^^^^^%)))))%^%)rr
)))----+--)))-+++----++-))%^%)))))))---)%^^^^^^^^^^^%)))))%^%)rr
)))-+--++-)))-++-+----+-))%^%)))))-)-+-))%^^RRRR^^^%)))))))%))rr
)))-+++++-)))-------)-+-))%^%))))))--+-))%^RrRR^^^^%)))))))$))rr
))--+-----)))))))))))---)))%%%)))%%%---))%^RR^^^^^^^%)))))))))rr
-------))))))))))))))))))))))%%%%^^%)----%^R^^^%%^^^(())))))))rr
-+---)))))))))))))))))))))))))%^^^^%))-+-%^R^^%))%^^(())))))))rr
--+---)))))))))))))))))))))))))%%%%))--+-%^^^%-)))%%%%))))))))rr
--+++-)))))))))))))))))))))))))))))))-+---%%%%-)))))))))))))))rr
-++++-)))))))))))))))))))))))))))))))--++-------))))))))))))))rr
rrrrrrrrrrrrrrrrrrrrrrrrrrrrrrrrrrrrrrrrrrrrrrrrrrrrrrrrrrrrrrrr
rrrrrrrrrrrrrrrrrrrrrrrrrrrrrrrrrrrrrrrrrrrrrrrrrrrrrrrrrrrrrrrr
