)%^^^%))))))----+-%^^%))))))))))))%^%)))))))))))))))))))))))))rr
)%%%%%%)))---+-----%^^%%%))))))))%^^%)))))))%%))))))))))))))))rr
)))))----)-+-+-----)%^^^^%))))))%^^^^%))))%%^^%%%%%%))))))))))rr
)))---++-)-++++---)))%^^%)))))))%^^^^%))))%^^^^^^^^^%)))))))))rr
-))-++---)--------))))%^%--)))))(^^^^%))))%^^(^^^^^^%)))))HH))rr
)))-+--))))%%%%%%%))---$----)))))%^^%))))))%%^^^^^%%))))HHH)))rr
)))---))))%^^^^^^%))-----++-)))))%^^%))))))))%^^^%)))))))HH)))rr
)))))-)))%^^^R^^^%))-+-+-+--))))))%^%))))))))-%%%-))))))))))))rr
))))))))%^^^^^R^%--)-----+-)))))))%^^%)))))))-----))))))))))))rr
))))))%%^^^%%^^^%)-))------))))))$%%^^%%%))))-++--))))))))))))rr
)))))%^^^^%))%%^%)-))-+-))))))))))))%^^^^%%%%--+-)))))))))))))rr
)))))%^^^%)))))$)))))---))%%%%%%)))))%^RRR^^^%---)))))))))))))rr
)))-))%%%)))))))))))))))%%^^^^^%)))))%^^R^^^^%--)))))))))-----rr
))))-))))))))))))))%%%)%^^^^^^^^%)))))%^^%%%%^%))))))))))-+++-rr
)))--)))))))))))))%^^^%^^^^^^^^^%)))))%(%))))%^%))))))%(%-+++-rr
))-)))))))))))))))%^^^^^^^%%%%%%%)))))))))))))%%))))))%^%--+--rr
)))))))))))))))))$^^^^^^%%)))))))))))))))))))))%))))))%^%)-++-rr
))))))))))--))))))%%%%%%)))))))))))$)))))))))))%)))))))$))----rr
)))HH))))-++-)-)))))))))))))))))))%^%)))))))))%%----))))))))))rr
))HHH)))-------))))))))))))HH))))%(^^%)))))%%%^(-++-))))))))))rr
)HHHH)))))---+-))))))))))))))))))%^^%%)))))%^(^%--+-))))))))))rr
))))))))))-+++-)))))))%%%%))))))%^%%))))))))%((%----))))))))))rr
))))))))))-+-+-)))HH))%^^^%%)))%%%))))))))))))%%%%%%%%%)))))))rr
))))))))))-----))HHH))%^^^^^%%%%))))))))))))))))%^^^^^%)))))))rr
))))))))))))-)))))H)))%^^^^^^^^%)))))))))))))))))%(^^^%)))))))rr
)))))))))))))))))))))))%^^^^^^^%)))))))))))))))))%^^^^%)))))))rr
))))))))))))))))))))))))%^^^^^^%)))))))))%%%%))))%^^^^%)))))))rr
)))))-)))))))))---)))))))%^^^^^%))))))))%^^^%))))%^R^^%)))))))rr
))))----))))))--+--))))))%^^^^^%)))))))%^^^^%))))%^R^%))))))))rr
))))-+--)-))---+-+-))))))%%%%^^%))))))%^^RR^%))))%^R^%))))))))rr
))))-+-%%))))-++---$)))))))))%%%))))%%^^RrR^%))))%^R^%))))))))rr
)))--+-%%))))----$%^%%)))))))))%%%%%^^^^RRR^^%)))%^R^%))))))))rr
)))--+---))))))--)%^^%))))))))))%%^^^^^^^^^^^%)))%^^^%))))))))rr
%---++--)))))))))))%%%))))))))))--%%%%%%^^^^^^%%%^^^%)))))))))rr
^%--+-+--))))))))))))))))%%%%)))------))%^^^^^^^^^^^%)))))%%%%rr
^%-++--+-)))))))))))))))%^^^%)))-++++-)))%^^^^^^^^^%))))))%^R^rr
^%--+++--))$)))))))))%%%^^^%))))-+++--)))%^^%%%%%%%%)))))$^RRRrr
%))--++-)))%%))))))%%^^^^^%)))))-----%%%%^^%)))))))%))))))%^^^rr
%)))----))%^^%))))%^^^^^^%)))))))))%%^^^^^%))))))))%))))))%^^^rr
%)))-)))))%^^%))))%^^^^^%))))))))))%^^^^^%%)))))))%^%)))))%^^^rr
%))))))))%%%%))))--%%%%%))))))))))))%%%%%)())-))))%%^%)))%^^^^rr
%)))))))%%)))))))))-))))))))---)))))))))))))))))%%))%^%%%^%%%^rr
%))))))%%)))))))))))))))))))----)))))))))))))-%%^%)))%^^^%)))%rr
%))))))%%)))))))))))))))))%%%-+-)))))))))))-))%^%)))))%^%))))%rr
%))))))%))))))))))-)))))))%^%-+--)))))))))))))%^%))))))%%)))))rr
%)))))%^%)))))))))))))))))%^%-++-)))%%%%%))-))%^%)))))))))))))rr
^%)))%^^^%)))))))%%%%)))))%%-----))%^^^^^%)))%^^%))))))HH)))))rr
^^%%%^^^^^%%%%))%^^^^%))))%%))-)))%^^^RR^^%)%^^^%)))))))))))))rr
%%^^^^^^^^^^^^%%^^^^^^%))%%))))))%^^^^^R^^^%^^^^%)))))))))))))rr
))%^^^%%%^^^^^^^^^%%%^^%%^%))))))%^^^^^^^^^^^^^^%)))))))))))))rr
))%^^%)))%^^^^^^^%)))%^^^%))))))%^^^^^^^^^^^^^^^^%%%%%)----)))rr
)%^^%)))))%^^^%%%)))))%^^%))))))%%^^^^^^^^^^^^^^^^^^^^%%-+-)))rr
@@^^%)))))%^^%)))))))))%%)))))))))%^^^^^^^^^^^^^^^^^^%------$)rr
@@^%))))))%^%)))))))----))))))))))%^^^^^^^%^^^^^^^^^%)-++--%^%rr
##^%))))))%%)))))----++--)%%))))))%^^^^^^%)(^^^^^^^%))----%^^^rr
!!%)))))))%^%))))-+++++--%^^%)))))%^^^^^^%)))%^^^^^%))))))%^R^rr
!!)))HH))))%%))))--+++--%^^^%)))))%^^^^^^%))))%^^^^^%))))%^^R^rr
%-))HHHHH))%^%))))--+--%^^^%^%)))%^^^^^^^^%))))%%^^^%))))%((^^rr
--))HHHH)))%^%)))--+--%^^%%)%%%%%^^^^^RR^^^%---))%^^%---))((^^rr
+--))HH))))%%)))))----%%%))))))%%%%%%^^^^^^%-+-))%^^^%---)))%%rr
++-))))))))))))))))))))-)))))))))))))%%%%%%--+---%%%%--+-)))))rr
+--))))))))))))))))))))))))))))))))))))))----+-+-))------)))))rr
rrrrrrrrrrrrrrrrrrrrrrrrrrrrrrrrrrrrrrrrrrrrrrrrrrrrrrrrrrrrrrrr
rrrrrrrrrrrrrrrrrrrrrrrrrrrrrrrrrrrrrrrrrrrrrrrrrrrrrrrrrrrrrrrr
