^&&)&^))))))))))))))------++-----))))))))+++%+))))^&&^))^&&&))))
&))&&&^)))))))))))))--+++++++++--))))))))++^&^)))^&&&&^^&&^^^&))
&&&&)&&^^)))))%^^^))--+++----++--))))))))))^&&^^)&&&&&&&&^)))^))
&&)&&&&&^))))))^^^^^)--+--^^^-+--))))))))))^&&&&&&)&&)&&^)))))))
&&))&)&&^)))))))))^&^)----^^^^---)^^))))))))^&&&&&)&&^^^-)))))))
&&&^^&&&^))))))))))^^)))---))^^^^^&^))----)))^&&&&&&^)-----))^))
&&^))^&&&^))))))))))))))))))))^&&&)&^)--+++--)^&&)&&^)--++-)^&))
&^)))^^&^)))))))))))))))))))))^&&))&^--++++-)+^&&&&&^))-+--^&&))
^))))))%)))))))))))))))))))))))^&))&^)-+++---))^&&^^)))---)^^&))
)))))))))))))))))))))))))))))))^&&&&^)-++--))))^&^)))))))))))^))
))))))))))))))))))))))))))))))))^&&&^)----))))^&^)))))))))))))))
)^^^)))))))))))))))))))))))^^^^)^&&&^)))))))))^^))))))))))))))))
^&&&^))))))))))))))))))---^&&&&^&&&&&^))))))))))))))))))))))))))
&&&&&^)))))---)))))))))---^&&&&&&&&&&&^)))%)))))))))))))))))))))
&&&&&&^^))----))))))))--+-^&&&&&&&&^&&&^^^&^))))))))))^^^^^^^^))
&&&&&&&&^^^---)))))))))-+-^&&&&&&&^)^&&&&&&&^))))))^^^&&&&&&&&))
&&&&&&&&&&&^^-)))))))))-+-^&&&&&&^))-^&&&&&&^)))))^&&^^^^^&&&&))
&&&&&&&&&&&&&^^))))))))---^&&&&&&^-))^&&&&&&&^)))^&&^)))))^&&&))
&&&&&&&&&&&&&&&^))))))))))^&&&&&^)-)))^&&&&&&&^^^&&&^)))))^&&&))
&&&&&&&&&&&&&&&^))))))))))^&&&&&^))))))^&&&&&&&&&&&&^)))))^&&&))
^^&&&&&&&&^^^^^^)))))))))^&^^^^^)--))))^&&&&&&&&&&&^^)))))^^^^))
))^&&&&&&^)))))))))))))^^&^)))))))))))))^^^^^&&&&&^))))))))---))
))^&&&&&^)))))))))))^^^&&^)))))))))))))))))))^&&&^)))))))))-+-))
-)^&&&&&^---))))))^^&&&&&^)))))))))))))))))))^&&^))))))))))---))
-^&&&&&^--+--))))^&&&&)&&^)))))))))))))))))))^&&^)))))))))))--))
^&&&&&&^-++-)))))^&&&&)&&^)))))))))))))))))))^&&^)))))))))))--))
&&&&&&^--++-)))))^&&&&))&&^^^^^^^^^^)))))))^^&&&^)))))))))))--))
^&&&&&^-^^^^^))))^&&&&))&&&&&&&&&&&^)))))))^&&&&^)))))))-----)))
)^^^^&&^&&^^^^)))^&&&&&)&&&&&&&&&&^^))))))))^&&&^)))))))-+++-)))
)))))^&&&^---)))%^^^^&&&&&&&&&&&&^)))))))))))^^&^))))))-++++-)))
))))))^&^----))))))))^&&&&&&&&&&^))))))))))))))^&^^^)))------)))
))))))^^)---))))))))))^&&&&&&&&^))))))))))))))))^&&&^)))--^^-)))
))))))))--))))))))))))^&&&&&&&&^)))))))))))))))))^&&&^)))^^^^)))
))))))))))))))))))))))^&&&&&&&&&^)))))))))))))))))^&&&^^^^))))))
))))))))))))))))))))))^&&&&&&&&&^)))))))))))))))))^&&&&&^))+))))
))))))))---)))))))))))^&&^^^^^^^)))))))%^^^)))))))^&&&&^)))+))))
)))))---++-))))))))))))^^---++--))))))))^^^^))))))^&&^^)))))))))
)))))--++++-)))))))))))))--++++--))))))))))^))))))^&^)))))))))))
)))))-+++++-)))))))))))))--+++++-))))))))))%))))))^&^)))))))))))
))))))-++---))))))))))))))-+++++-)))))))))))))))))^&^)))))^^^^))
))))))-++-))))))))))))))))-+++++-))))))))))))))))))^^)))))^&&&))
))))))-++-))))))))))))))))--++++-))))))))))))))))))^^)))))^&&&))
^^^))))---))))))))))))^^^))))-+++-))))))))))))))))))%)))))^&&&))
&&&^))))))))))))))))))^&^))))-++++-))))))))))-))))))))))))^&&&))
&&^^^)))))))))))))))))^^^))---+++++--)))))-))))))))))))))))^&&))
&^)))%)))))))))))))))))))))--++++++--))))))))-)-----))))))))^&))
^)))))%)))))))))))))))))))^^-++++++--))))))))))--+-^^))))))))^))
^)))))^^)))))))%)))))))))^&&^-+++--))))))))))))---^&^-))))))))))
^))))))^)))))))%))))))))^&&&&^++--)))))))))))))---^&&^))))))))))
^))))))^)))))))))))))))^&&&^^^---))))))))))))))))^&&&&^)))))))))
)))))))%))))))))))))))^&&&^))-)))))))))))))))))^^&&&&&&^^^)))^))
)))))))))))---))))))))^&&^))))-))))))))))))))))^&^^^^^&&&^))%&))
))))))))))-+++-)))))))^&^)))))))))))))))))))))))))))))^^^))))^))
))))))))))-++-)))))))^&&^)))))))--)))))))))))))))))))))))))))^))
))))))))))-++-)))))^^&&&^))))-++-)))))))))))))))))))))))))))))))
---))))))))--))))))^&&&^^))))-++))))))))))))))))))))))))))))))))
-++-))))))))))))))))^^^))))))-----))))))))))))))))))))))))))))))
-+++--)))))---))))))))))))))))))))))))))))))))))))))))))))))))))
-+++++--)))-++----))))))))))))))))))))))))^^))-)))))))^)))))))))
--++++--)))-+++++-)))))))))))))-)))%^^)))%^^---))))-))^^^)))))))
--++++--))))-++++-))))))))))))---))))))))))-----)))-))))))))))))
--------))))-----))))))))))------))))))))))))))))-))))))))))))))
))))))))))))))))))))))))))))))))))))))))))))))))))))))))))))))))
))))))))))))))))))))))))))))))))))))))))))))))))))))))))))))))))
