^&&&&^)))^^^^^^^^^^^^)++++^&&&&^))))))^&^))++++++))))))))))^&^))
&&r&&^))))))))))))))))++++^&&&&^)))))^&&^))))+++))))))))))))^&))
&&r&&^)))))))))))))))))++++^&&&&^))^^&&&^))))+++)))))))))))))^))
&&rr&^)))))))))))))))))++++^&^^^&^^&&&&&^))))))))))))))))))))^))
&&rr&&^))))))))))))))))+++^&^)))^&&&&&&&^)))))))))))))))))))))))
&&&&&&&^^))))))))))))))))^&&^))))^&&&&&&^))))))))))))))))))))^))
&&&&&)&&&^^^^))))))))))^^&&&^))))^&&&&&&^))))))))))%)))))))))^))
&&&&&&&&&&&&&^))))))))^&&&&&^))))^&))&&&^)))))))))^&^))))))))^))
^^&&&&))&&&&^^))))))))^&&&&&&^)))^&))&&&^++))))))^&^))))))))))))
))^&&)&&^^^^)))))))))^&&&&&&&&^^^&&&&&&&^++++)))^&^)))))))))))))
))^&&&&^))))))))))))^&&&&&&&&&&&&&)&&&&&^+++))^^&^))))))))))))))
)^&&&&^))))))))))))^&&&&&&&&&&&&&&&&&&&^+++++)^^^)))))))))))))))
)^&&&&^)))))))))))^&&&&&&&&&&&&&&&&&&&^^+++++)))))))))))))))))))
+^&&&&&^^))))))))^&&&&&&&&&&&&&&&&&&&^)++++++++)))))))))))))))))
++^^&&&&&^^^^^^^^&&&&&&&&&&&&&&&&&&&&^))))+++++)))))))))))))))))
++++^^^&&&&&&&&&&&&&&&&&&&))&&&&&&&&&^)))++++++)))))))))))++++))
+++++++^^^^^&&&&&&&&&&&&&&&&^^^&&&&&&^)))+++++++))))))+)))++++))
++^^^+++))))^&&&&&^^^&&&&&&^)))^^^^^^))))+++++++)))))))))+++++))
++^&^+++)))))^&&&^)))^&)&&&^))))))))))))))++++++)))+)))))+++++))
+^&&&^++)))))^&&^))))^&&&&^)))))))))))))))+++++))))+)))))+++++))
+^&&&^++))))))^^))))))^^^^))^^^)))))))))))+++)))))))))++++++++))
)^&&&^)))))))))%)))))))))))^&&&^^^^^^))))))))))))))))+++++++++))
))^&&^))))))))))))-))))))))^&&&&&&&&&^^)++++)))))))))+++++++++))
))^&&^)))))))))))----)))))^&&&&&&&&&&&&^++++)))))))^^+++++++++))
))^&&&^)))))))))--+---))))^&&&&&&&&&&&&&^+++)))))))^&^)+++++++))
)))^&&&^^^^^^)))-+---%)))^&&&&&&&&&&&&&&^++++)))))))^&^^+%++++))
)))^^&&&&&&&&^--+++--^^^^&&&&&&&&&&&&&&&^++++))))))))^&&^^)+++))
)))))^^&&&&&&^-+++++--^&&&&&&&&&&&&&&&&&&^+++)))))))))^&^))+++))
)))))))^&&&&&^-++++--))^^^&&&&&&&&&&&&&&^++++++))))))))%))++++))
^^))))))^&&&^--++++-))))))^&&&&&&&&&&&&&&^++++)))))))))))))^^^))
&^)))))))^^^--++++--))))))^&&&&&&&&&&&&&&&^^^+)+)^^^^)))))^&&&))
^))))))))))--++++---))))))^&&&&&&&&&&&&&&&&&&^^^^&&&^)))))^&&&))
)))))))))))---++--)))))))^&^^&&&&&&&&^^^^&&&&&&^&&&&^)))))^&&&))
)))))))))))------)))))))^&^))^^^^&&&^))))^&&&&^+^&&&^)++++^&&&))
^)))))))))---++--)))))))^^)))))))^&&^))))^&&&&^++^&&^)++++^&&&))
^)))))))))-++++--)))))))))))))))))^&^))))^&&&&^++^&&^)+++^&&&&))
&^))))))))--++---)))))---))))))))))%)))))^&&&&^++^&&&^)++^&&&&))
&^))))))))-++++--)))))----)))))))))))))))^&&&&&^^&&&&&^^^&&&&&))
&^))))))))-+++--))))))--++--)))))))))))))^&&&&&&&&&&&&&&&&&^&&))
&^))))))))--++--)))))--++---)))))))))))))^&&&&&&^&&&&&&&&&^)^&))
^)))))---)))++-)))))))-+++--)))))))---))^&&&&&^^)^&&&&&&&^)))^))
^))))----)--++--)))))-+++--))))))---+-^^&r&&&^))))^&&&&&&^)))^))
^))))--^^)--++---)))-++++--))))))--+-^&&&&&&&^))))^&&&&&&^)))^))
^)))-----)--++---))--++++-))))))--++-^&&&&&&&^))))^&&&&&&^)))^))
)))))----))++----)))-++++-))))))--++--^^&&&&&^))))^^^&&&&^))))))
))----++-))--+---)))-+++++---)))--+++-))^^&&&&^))))))^&&&^))))))
----+++++))-++--)))))-+++---)))))))---))))^&&&^))---))^&^)))))))
-++++++++)-+++--)))))-++++--)))))))))))))))^&&^)----))^&^)))))))
-+++++++---++---)))))-++++--)))))))))))))))^&^))----)))^))))))))
)-++++---)--+++))))))+++++++)))))))))))))))^&^))-----))^))))))))
))--+---)))-))))))))))+++++))))))^^^))))))^&&^))----)))^^)))))))
)))----)))))-)))))))))+++))))))))^&^)))))-^&&^)))))--)-^^)))))))
))))))))))))))))))))))))))))))))))^^))))---^&&^))))))-)^^))))^))
^)))))))))))))))))))))))))))))))))))))))----^&&^))))-))))))))^))
&^^)))))))))))))---)))))))))))))))))))))-----^^^)-)))))))))))^))
&&&^))))))))))------))))))))))))))))))))))----)%)))-)))))))))^))
&&^^^))))))))))-----))))))))))))))))))))))))))))--)))^^^^^)))^))
&^)))))))))))))-----)))))))^^^))))))))))))))))))))))))&))^)))^))
&^)))))))))))))-----))))))^&&&^^^^^)))))))%))))))))^))&))^))))))
^)))))))))))))))---))))))^&&&&&^^^)))))))%^^)))))))^&&&&^)))))))
)))))))))))))))))))-)))))^^^^^^)))))))))))))))))))))^^^^))))))))
))))))))))))))))))))))))))))))))))))))))))))))))))))))))))))))))
))))))))))))))))))))))))))))))))))))))))))))))))))))))))))))))))
))))))))))))))))))))))))))))))))))))))))))))))))))))))))))))))))
